bull|n.公牛；股市看涨的人；警察; n.荒谬的话; n.教皇诏书; adj.公牛的；鲁莽的
journey|n.旅程；旅行；行程; v.旅行
hesitate|vi.犹豫；不情愿；口吃
sharp|adj.锋利的；突然的；灵敏的；明显的；辛辣的；【音】升音阶的; adv.准时地；突然地；偏高地
snuggle|v.依偎；挨近
symptom|n.症状；征兆
seashore|n.海滨
bent|bend的过去式和过去分词.; adj.下定决心的；弯曲的; n.嗜好
glimpse|n.一瞥；一闪；略微；隐约感觉; v.瞥见
admire|vt.钦佩；赞美；羡慕；欣赏
relieve|v.救济；减轻；解除；偷
chimpanzee|n.黑猩猩
lunchroom|n.速简餐厅
smoothly|adv.平滑地；流畅地
disturb|v.扰乱；妨碍；使...不安；打破...的平静；打乱...的治安
ancient|adj.古老的；古代的; n.古人
stockings|n.长袜
suffer|vt.遭受；忍受；容忍，宽恕，听任；允许，准许; vi.受苦；患病；受损失；变差，变糟；处于不利地位
unique|adj.独特的；独一无二的；稀罕的
aspect|n.方面；方位；外观；外貌
invasion|n.侵略；侵入
blacken|v.(使)变黑；诽谤
ventilate|vt.使...空气流通；通风
dismay|n.沮丧；绝望; vt.使...沮丧；使...惊愕
painter|n.画家；油漆匠
presto|adv.(音乐演奏)急速; adj.(音乐)急速的; n.(音乐)快拍；急速
accidentally|adv.偶然地；意外地；附带地
blaze|n.火焰；烈火；光辉；(光或色彩的)展现；(感情的)迸发；(动物面部的)白斑；记号; v.燃烧；发光；迸发；传播；在(树皮)上刻记号
tyre|n.轮胎; =tire（美）.; Tyre：提尔(古代腓尼基的有名港口；现属黎巴嫩).
companion|n.同伴；志趣相投的人；成对物品之一；参考书; v.陪伴
playgrounds|游戏场地
analysis|n.分析；解析
spite|n.恶意；怨恨; v.刁难；惹怒；冒犯
handball|n.手球；墙手球运动
prance|v.腾跃；欢跃；昂首阔步; n.(马)后足立地腾跃；昂首阔步
weep|v.流泪；哭泣；悲叹；渗出; n.哭泣；眼泪
culture|n.栽培；文化；教养; vt.培养，栽培
extraordinary|adj.非凡的；特别的；特派的
encouragement|n.鼓励；激励
hummingbird|n.蜂鸟
pipe|n.管子；烟斗；管乐器; vt.以管输送；装管道；吹奏；尖声说；(为衣服等)滚边; vi.吹奏管乐；尖叫
express|n.快车；快递；专使; adj.明确的；急速的；直接的; adv.用快递; vt.表达；表示；挤压出；快递
evade|v.逃避；躲避；规避
vital|adj.至关重要的；有活力的；生死攸关的
atmosphere|n.大气；空气；气氛；气压
port|n.港口
enthusiast|n.热心人；热衷者
storybook|n.故事书；小说; adj.故事般的
unimaginative|adj.（艺术品）缺乏想象力的；无趣的
ratty|adj.糟糕的；破烂的；卑鄙的；像老鼠的；鼠多的; adj.恼怒的
amusement|n.乐趣，娱乐；消遣
buoy|n.浮标；浮筒；救生圈；救生衣; v.使浮起；支持；鼓励；用浮标指示
snatch|n.抢夺；一阵；一点点; v.夺取；抓住
guarantee|n.保证；保证书；担保；担保人；抵押品; vt.保证；担保
exist|v.存在；生存；活着
occasion|n.场合；时机；理由；机会；盛大场面; vt.引起；致使
tendency|n.趋势；倾向；秉性
sculptor|n.雕刻家
petrol|n.汽油
pastry|n.面粉糕饼；馅饼皮
explosions|爆炸
horsepower|n.马力(功率单位)
clatter|n.咔嗒声；哗啦声；嘈杂的谈笑声; v.发出哗啦声；咔嗒咔嗒响；喧闹地谈笑；使发出咔嗒声
concentration|n.集中；专心；浓度
footstep|n.脚步；脚步声；足迹
apologize|vi.道歉；赔罪
construction|n.建设；结构；建筑物；建造；构造；解释
temple|n.神殿；寺院；庙宇; n.太阳穴，鬓角
cod|n.鳕鱼; v.哄骗；愚弄
declare|v.宣布（声明）；申报；声明
consistent|adj.始终如一的；持续的；一致的
anxiously|adv.焦急地；忧虑地；担心地
practical|adj.明智的；实际的；实用的；事实上的; n.实践考试
examiner|n.主考者；审查员
secure|adj.安全的；牢靠的；稳妥的; vt.使安全；获得；固定
gust|n.突然一阵; n.风味; vi.猛吹
vehicle|n.车辆；交通工具；传播媒介；手段；工具
baguette|n.法式长棍面包；长方形的宝石
academic|adj.学院的；学术的；理论的; n.大学教师，大学生；学者，学究
bedside|adj.床边的；病床边的; n.床边
brim|n.边；边缘; v.（装）满；（使）溢出
handful|n.一把；少数；难控制的人；棘手之事
frighten|vt.使惊吓；害怕; vi.惊吓
keepsake|n.纪念品
speedboat|n.快艇
tricycle|n.三轮车
of|prep.关于；...的（表所属）；出身于；由于
polecat|n.臭猫；臭鼬类动物
spread|v.传播；展开；散布；铺开；伸展；涂撒; n.范围；传播；差额；幅度；盛宴
identify|vt.鉴定；识别，辨认出，认出；认明；把…看成一样; vi.认同；感同身受
airfield|n.飞机场
concern|n.关心；关心的事；忧虑，担心; vt.涉及；影响；关心；（使）担心; n.公司；企业
stare|v.盯着看；凝视; n.凝视
landlord|n.地主；房东
quarrel|n.吵架；争论；怨言; vi.吵架；争论；挑剔
diver|n.跳水者；潜水员
headmaster|n.(中小学的)校长
critically|adv.批评性地；爱挑剔地；重要地；危急地
burst|n.爆发；破裂；阵; v.爆裂；迸发；冲；闯
sagebrush|n.山艾(美国西北荒漠产的一种灰绿色灌木)
