bull|n.公牛；股市看涨的人；警察; n.荒谬的话; n.教皇诏书; adj.公牛的；鲁莽的
hesitate|vi.犹豫；不情愿；口吃
sharp|adj.锋利的；突然的；灵敏的；明显的；辛辣的；【音】升音阶的; adv.准时地；突然地；偏高地
seashore|n.海滨
admire|vt.钦佩；赞美；羡慕；欣赏
relieve|v.救济；减轻；解除；偷
delight|n.高兴；快乐; v.(使)高兴；(使)欣喜
tulips|郁金香
chimpanzee|n.黑猩猩
smoothly|adv.平滑地；流畅地
vibration|n.震动；颤动
salary|n.薪水; v.给...薪水
ancient|adj.古老的；古代的; n.古人
artiste|n.艺人；表演艺术家
suffer|vt.遭受；忍受；容忍，宽恕，听任；允许，准许; vi.受苦；患病；受损失；变差，变糟；处于不利地位
wheeze|v.喘息；呼哧呼哧地响; n.喘息声
worthless|adj.无价值的；无用的；可鄙的
unique|adj.独特的；独一无二的；稀罕的
caribou|n.北美驯鹿
aspect|n.方面；方位；外观；外貌
reputation|n.好名声；声誉，名声，名气
blacken|v.(使)变黑；诽谤
ventilate|vt.使...空气流通；通风
officially|adv.官方地；正式地；公务上；职务上
dismay|n.沮丧；绝望; vt.使...沮丧；使...惊愕
actress|n.女演员
lighthouse|n.灯塔
presto|adv.(音乐演奏)急速; adj.(音乐)急速的; n.(音乐)快拍；急速
sympathetic|adj.同情的；共鸣的；赞同的; n.交感神经
blaze|n.火焰；烈火；光辉；(光或色彩的)展现；(感情的)迸发；(动物面部的)白斑；记号; v.燃烧；发光；迸发；传播；在(树皮)上刻记号
spite|n.恶意；怨恨; v.刁难；惹怒；冒犯
sender|n.寄件人；发报机；送话器
weep|v.流泪；哭泣；悲叹；渗出; n.哭泣；眼泪
encouragement|n.鼓励；激励
port|n.港口
hummingbird|n.蜂鸟
express|n.快车；快递；专使; adj.明确的；急速的；直接的; adv.用快递; vt.表达；表示；挤压出；快递
vital|adj.至关重要的；有活力的；生死攸关的
evade|v.逃避；躲避；规避
atmosphere|n.大气；空气；气氛；气压
storybook|n.故事书；小说; adj.故事般的
caller|n.打电话的人；来访者；呼叫者
fortunately|adv.幸运地；幸亏
despair|n.绝望；失望; vi.失望
application|n.应用；申请；专心；应用程序
burners|炉
buoy|n.浮标；浮筒；救生圈；救生衣; v.使浮起；支持；鼓励；用浮标指示
snatch|n.抢夺；一阵；一点点; v.夺取；抓住
exist|v.存在；生存；活着
tendency|n.趋势；倾向；秉性
sneer|n.冷笑；嘲笑; v.嘲笑；冷笑
petrol|n.汽油
czar|n.沙皇；独揽大权者
promptly|adv.迅速地；准时地；立即
performances|性能
peculiar|adj.奇怪的；特殊的；独特的；古怪的; n.特权
explosions|爆炸
clatter|n.咔嗒声；哗啦声；嘈杂的谈笑声; v.发出哗啦声；咔嗒咔嗒响；喧闹地谈笑；使发出咔嗒声
busiest|最忙的
concentration|n.集中；专心；浓度
footstep|n.脚步；脚步声；足迹
construction|n.建设；结构；建筑物；建造；构造；解释
reluctant|adj.不情愿的；勉强的
swimmers|白色有光绒面呢
temple|n.神殿；寺院；庙宇; n.太阳穴，鬓角
declare|v.宣布（声明）；申报；声明
rely|vi.依靠；信任
anxiously|adv.焦急地；忧虑地；担心地
limelight|n.众人注目的中心；聚光灯；以灰光灯照射的舞台; v.使受到注目
spoil|v.宠坏；溺爱；破坏；腐坏；使索然无味; n.战利品；奖品
departure|n.出发；离开；分歧；新的尝试
impatiently|adv.不耐烦地；急躁地
urge|vt.驱策；鼓励；催促；力陈; vi.极力主张; n.冲动；强烈愿望
baguette|n.法式长棍面包；长方形的宝石
brim|n.边；边缘; v.（装）满；（使）溢出
successfully|adv.成功地，圆满地
handful|n.一把；少数；难控制的人；棘手之事
frighten|vt.使惊吓；害怕; vi.惊吓
keepsake|n.纪念品
bury|vt.埋葬；隐匿；专心致志；抛弃
crashing|adj.绝对的；彻底的；非凡的
snowstorm|n.暴风雪；雪暴
of|prep.关于；...的（表所属）；出身于；由于
spread|v.传播；展开；散布；铺开；伸展；涂撒; n.范围；传播；差额；幅度；盛宴
desperately|adv.拼命地；绝望地；极严重地；孤注一掷地
fable|n.寓言；神话；无稽之谈; v.讲寓言；虚构
load|n.负荷；重担；装载量; v.装载；给(枪)装子弹；[计算机]装入
mournful|adj.悲恸的；悲哀的；令人惋惜的
stare|v.盯着看；凝视; n.凝视
budget|n.预算; vt.编预算；为...做预算; vi.节省开支; adj.廉价的；不贵的
landlord|n.地主；房东
quarrel|n.吵架；争论；怨言; vi.吵架；争论；挑剔
scaly|adj.有鳞的；剥落的；被虫蛀的；卑劣的
headmaster|n.(中小学的)校长
ex|prep.【商】在...交货，在…前免费；从，自，根据；【经】不，无，不包括; n.已离婚的丈夫（或妻子），过去的情人；字母X；X形物; adj.以前的，旧时的
software|n.软件
plot|n.情节；阴谋；图；(小块)土地; v.密谋；绘图；计划；标示位置
oldies|n.老人
retirement|n.退休；隐匿处
erect|vt.使竖立；建立；建造; adj.直立的；竖立的；笔直的
