ticket|n.票；券；标签；罚单；候选人名单; vt.加标签于；售票；开罚单；检票，查验票证
slim|adj.苗条的；微小的；细长的; v.减肥；缩减
wagon|n.四轮马车；货车; v.用四轮马车运
preserve|v.保护；保存；保持; n.禁猎区；蜜饯
cling|vi.紧贴；附着；依恋；坚持; n.紧抓；紧贴
musical|adj.音乐的；喜欢音乐的；悦耳的; n.音乐片
lowland|n.低地; adj.低地的; Lowland.; n.苏格兰低地
optimistic|adj.乐观的；乐观主义的
nicely|adv.精确地；漂亮地；恰好地
nighttime|n.夜间; adj.夜间的
nursery|n.托儿所；保育室；苗圃
scooter|n.踏板车；小型摩托车
separate|adj.分开的；不同的；单独的；各自的; v.分开；隔开；区分；分居；脱离; n.分开；抽印本
upstream|adj.上游的；逆流而上的; adv.向上游；逆流地
stud|n.大头钉；饰钉；立柱；板墙筋；壁骨；种马；耳环；年轻男子; vt.镶嵌；点缀
tune|n.曲调；调子；和谐；协调；数量; vt.为...调音；调整; vi.调音；调整频率
stash|vt.隐藏；储藏; n.隐藏地点；隐藏物
doorknob|n.球形门把手
darn|v.织补; n.补钉; int.该死（damn的委婉语）
brass|n.黄铜(制品)；铜管（乐器）；厚脸皮; adj.黄铜的
predicate|n.[语]谓语；述语; v.断定；意味；宣称；基于; adj.谓语的
February|n.二月
dairy|n.牛奶场；乳品店；乳制品；地方小店; adj.牛奶的；乳制品的
autograph|n.亲笔签名；手稿，原稿，手迹，真迹; v.亲笔签名于；亲笔书写
silver|n.银币；银器；银；银灰色; adj.银的；银色的; vt.镀银于；使...成银色
cuckoo|n.杜鹃；杜鹃的叫声; v.像杜鹃一样咕咕叫; adj.愚蠢的；疯狂的
bookstore|n.书店; =bookshop.
bossy|adj.专横的；爱发号施令的; n.母牛或者小牛
propeller|n.螺旋桨；推进器; =propellor.
trait|n.特征；特点；少许；一笔
predator|n.食肉动物；掠夺者；（动物的）捕食性天敌
parasite|n.寄生虫；寄生生物；食客
greed|n.贪心；贪婪；贪吃
wasps|胡蜂
tired|adj.疲倦的；疲劳的；累的；厌烦的; 动词tire的过去式和过去分词形式.
freak|n.怪人；狂热爱好者；怪事；反复无常; adj.奇异的；不正常的; vt.使强烈反应(震惊；畏惧); vi.在药物影响下变得异乎寻常
sprinkle|v.洒；撒；下稀疏小雨; n.少量散布的屑状物
Wednesday|n.星期三
official|adj.正式的；官方的；公务上的; n.官员
snail|n.蜗牛
offend|vt.冒犯；犯罪; vi.违反；令人不适
fiery|adj.火的；炽热的；激烈的；暴躁的；辛辣的
commentator|n.评论员；解说员；注释者
van|n.箱形客货两用车；(铁路的)有盖货车；[军]先锋；先导；翼; v.(用货车)运
certain|adj.确定的；肯定的；某事；某人；某种；（与人名连用；表示不认识此人）一位叫...；特定的；轻微的；微小的; pron.某些；某几个
uncles|n.叔伯
European|adj.欧洲的；欧洲人的; n.欧洲人
Saturday|n.星期六
lantern|n.灯笼；[建]天窗；屋顶气窗
anxious|adj.渴望的；忧虑的
corpse|n.尸体
modest|adj.谦虚的；适度的；端庄的；有节制的
observers|观测器
grooming|n.修饰；美容；（动物）梳理毛发
wedge|n.楔子；楔形物; vt.楔住；嵌；挤进
amaze|vt.使吃惊；使惊异; vi.惊讶; n.吃惊；好奇
April|n.四月
chimney|n.烟囱
miserable|adj.痛苦的；悲惨的；贫乏的；狼狈的
markers|标记
accomplishment|n.成就；完成
October|n.十月
virtuous|adj.有品德的；有德行的；贞洁的
tales|n.[律]候补陪审员召集令
responsibility|n.责任；职责；责任心
grassy|adj.长满草的；草绿色的；像草的
field|n.田地；领域；运动场；场地；田野；JAVA中的范畴; vt.接球；派……上场；顺利处理; vi.担任外场员; adj.田间的；野外的
hazard|n.危险；冒险；危害; vt.冒险；赌运气; 阿扎尔（英超切尔西队球员）
doorstep|n.门阶
outcome|n.结果；后果
curse|n.诅咒；咒骂；祸端; vt.诅咒；咒骂；使受罪; vi.诅咒；咒骂
license|n.许可证；执照；特许; vt.发许可证给；特许
squawk|n.叫声；嘈杂的抱怨; v.呱呱地叫鸣；喋喋不休地发牢骚
laboratory|n.实验室
approach|v.靠近；接近；接洽；要求；达到；动手处理; n.途径；方法；接近；接洽；要求；路径；进场着陆；相似的事物
August|adj.（a~）威严的；尊贵的; n.八月
promise|n.诺言；预示；约定；(有)希望; v.允诺；发誓；答应；有希望
gunpowder|n.火药
formations|群系
revenge|n.报仇；报复；报复心；雪耻机会; vt.报复；报仇
snowman|n.雪人
transition|n.转变；过渡
infer|vt.推断；猜测；暗示; vi.作出推论
thankful|adj.感谢的；感激的
America|n.美国；美洲
carve|v.雕刻；切割
cutter|n.裁剪者；切割器；快艇；小艇；轻便雪橇
pardon|n.原谅，宽恕，饶恕；赦免，赦免状; vt.原谅；宽恕，饶恕；赦免，免于治罪
September|n.九月
drown|vi.淹死; vt.淹死；淹没
comb|n.梳子；鸡冠；蜂房; v.梳理；彻底搜寻
orphan|n.孤儿; adj.孤儿的; vt.成孤儿
sequence|n.顺序；连续；次序；一系列; vt.按顺序排好
yen|n.日元; n.上瘾; vi.对...上瘾
abnormal|adj.反常的；不正常的；变态的; n.不正常的人
flee|vi.逃走；消失；逃避；(时间)飞逝; vt.逃离
embarrassed|adj.尴尬的；拮据的；局促不安的
scene|n.情景；场；景
bowler|n.玩滚球的人；投球手；圆礼帽
mermaid|n.美人鱼
