raccoon|n.浣熊；浣熊的毛皮
feathery|adj.生有羽毛的；柔软如羽毛的
fon|n.丰族(西非达荷美；尤指阿波美地区的一种黑人民族)；丰族语
shallow|adj.浅的；薄的; n.浅滩；浅处; v.变浅
cast|v.掷；抛；投；铸造；指定演员；加起来；投射(目光)；投(票)；预测; n.演员阵容；投掷；[医]固定用敷料
rebuild|v.重建；重新组装；恢复
worker|n.工人；工作者
reproduction|n.再现；复制；生殖；幼树
accidentally|adv.偶然地；意外地；附带地
tub|n.桶；浴盆；行进缓慢的旧船; v.装入桶；洗澡
seemingly|adv.表面上；似乎；看起来
volcanic|adj.火山的；猛烈的
gradually|adv.逐渐地
greatly|adv.很；非常；大大地
spade|n.铲子；铁锹; n.黑桃; v.铲
carnivore|n.食肉动物；食虫植物
instinctual|adj.本能的
bundle|n.捆；束；包；大笔钱; v.捆；把...扎成一捆；匆忙地走
ail|v.使...苦恼；苦恼；生病; n.小病
bedding|n.寝具（人或动物）
arc|n.弧；弧形物; vi.形成电弧；按弧形轨迹行进
circumference|n.圆周；周围；周长
igloo|n.（爱斯基摩人用冰雪凝块砌成的）拱形圆顶小屋；冰屋
ledge|n.架状突出物；壁架；暗礁；岩脊
pinecone|n.松球；松果
fire-resistant|adj.(=fire-retardnat)耐火的；防火的
magnetism|n.磁性；吸引力；磁学
limestone|n.石灰石
recall|n.回忆；取消；召回; vt.召回；恢复；回想起；唤起；与...相似
jee|int.哎呀(表示惊奇、兴奋)
maze|n.迷宫；曲径；迷惑; vt.使迷惑
whistle|n.口哨；汽笛；警笛; v.吹口哨；鸣汽笛；呼啸；吹口哨召唤
borer|n.穿孔者；钻孔器；船蛆；凿船虫
of-|用于offer前
maple|n.【C】枫树；槭树; n.【U】枫树干
n-|[机]正
cleanup|n.清除；大扫除；暴利; adj.（棒球）第四棒的
take-off|n.起飞
axles|多轴
distinct|adj.明显的；清晰的；不同的；独特的
hemlock|n.铁杉；毒芹；从毒芹提炼的毒药；毒汁
velocity|n.速度；迅速；速率
shelter|n.避难所；庇护；庇护所; v.保护；隐匿；庇护
minimize|v.将...减到最少；贬低
dump|vt.倾倒；抛弃；倾销；抛售；倾卸；[计]转储; vi.倾倒；突然落下; n.垃圾场；军需供应站
hem|n.褶边; vt.缝边；包围；约束
solute|n.溶解物
seagrass|n.海草
binoculars|n.双眼望远镜
relieve|v.救济；减轻；解除；偷
someplace|adv.在某处
croak|v.嗄嗄叫；发牢骚；死; n.呱呱声；哇哇声
open-circuit|adj.开路的
shipping|n.船运；发货；运输；乘船
pad|n.便签纸；衬垫；发射台；公寓；脚印；肉趾; n.低沉声音；缓慢行走的马; v.填塞；夸大; v.轻轻走
reuse|vt.重新使用; n.再使用
turbine|n.涡轮
blossom|n.花；开花；全盛期; vi.开花；成长
trout|n.鳟鱼；鳟鱼肉
irregular|adj.不规则的；不整齐的；不合法的；不合规矩的; n.不合格品；非正规军
smiley|adj.微笑的; n.[计]笑容符
emptiness|n.空虚；空旷；空地
incandescent|adj.光亮的；炽热的；白热化的；暴怒的
aquifer|n.含水土层(含水量足以成为井水或泉水)
motion|n.移动；动作；打手势；示意；提议；大便; v.示意；运动；向...打手势
depths|pl.深处
four-wheel|adj.四轮的
sturdy|adj.强健的；坚固的；坚决的
gravel|n.碎石; v.铺碎石；使困惑
enclosed|adj.被附上的; v.附上; vbl.附上
chemically|adv.用化学；以化学方法
proved|v.证明(证明是；检验；勘探；证明；试印)
toddlers|儿童短衫
tion|suf.表示“行为”；“状态”等
fertilize|v.施肥；使肥沃；使丰富；[生]使受精；使受粉
tat|vi.梭织; vt.用梭织法编织; n.转移活化基因
coal-burning|adj.燃煤的
tal|n.轻打
screwdrivers|n.螺刀；螺丝批；螺丝起子
dandelion|n.蒲公英
blink|v.眨眼；闪烁；拒绝承认或面对；用闪光灯传送信号; n.眨眼；闪光；一瞬间
hardboiled|adj.强硬的(无情的；切实的)
coupon|n.息票；参赛表；票券；礼券；(购物)优惠券
sheet|n.被单；纸；(薄)片；一片; n.[船]帆脚索; v.铺盖；使成片; adj.片状的
bagel|n.百吉饼；硬面包圈
viceroy|n.总督；副王峡蝶
liq|液体
ridge|n.脊；山脊；山脉；隆起部; v.（使）成山脊
faucet|n.水龙头
igniter|n.点火器；触发器；引燃装置
waterfall|n.瀑布
triangular|adj.三角形的；以三角形为底的；三方的；(感情上)三角关系的
lens|n.镜头；镜片；透镜；(眼球的)水晶体; v.给…摄影；给…拍照
beak|n.鸟嘴；鸟嘴状物体；鹰钩鼻; n.地方治安官；校长
responsibly|adv.负责地；可靠地
coverings|n.覆盖物
harvard|n.哈佛大学(美国)
ork|[美口]=orchestra
germinate|v.发芽；开始生长
watersheds|分水岭
overtime|n.加班时间(加班加点费)；(比赛)延长时间; adv.在规定时间之外(超出时间地)
technician|n.技术员；技师
pizza|n.比萨饼
automatically|adv.自动地；机械地
insulator|n.绝缘体；绝热器
sparrow|n.麻雀
compass|n.圆规；指南针；范围; vt.达到；围绕；图谋
aloe|n.芦荟；芦荟油
reel|v.卷；绕; v.眩晕；旋转；蹒跚; n.卷筒；线轴
helium|n.氦
lei|n.（夏威夷人戴在颈上的）花环
cancer|n.癌；肿瘤；毒瘤; Cancer.; n.巨蟹座
raccoons|浣熊
wedge|n.楔子；楔形物; vt.楔住；嵌；挤进
firehouse|n.消防队
lighthouse|n.灯塔
newt|n.蝾螈
two-dimensional|adj.两维的；没有深度感觉的
freight|n.（货运）运费；货运；货物; vt.装货于；运送
splash|n.溅泼（声）；溅泼的量；溅污的斑点；骚动；少许; v.溅（湿）；报道
emerald|n.翡翠；绿宝石；翡翠绿; adj.翡翠的；翠绿色的
manufacture|v.（手工）制造；捏造; n.制造；制造业；（复）产品
meterstick|n.米尺(指长度为1米的尺)
feeder|n.饲养者；进食者；供给者；输电线；分支；支流；支线驳船
bump|v.碰撞；颠簸而行；提高; n.肿块；撞击；表面隆起; adv.突然的；猛烈的
paj|洋纺
dopa|n.多巴(二羟基丙氨酸)
oxide|n.氧化物
lev|n.列弗(保加利亚货币名；等于100斯托丁基stotinki)
bulge|n.膨胀；暴增; v.膨胀；充满
walrus|n.海象
accurately|adv.准确地；精确地
chewy|adj.柔软而会粘着的；耐嚼的
index|n.指数；索引；(刻度盘上的)指针; v.指出；编索引
recruit|v.吸收(新成员)；征兵；招聘; n.新成员；新兵
nectar|n.花蜜；甜美的饮料；众神饮用的酒
tornado|n.龙卷风；飓风；旋风
stamens|n.雄蕊
bedrock|n.岩床；根底；基础；基本原则
ho|int.（表示惊讶；喜悦等）嘿；嗨；嗬; n.妓女
strange-looking|adj.样子奇怪的
sexually|adv.性别地；两性之间地
blustery|adj.大风的；猛烈的；狂暴的
extensive|adj.广泛的；广阔的；广大的；大量的
crush|v.压碎；击败；使...失望；折皱；压榨; n.压碎；压榨；极度拥挤；迷恋
materia|斜纹布
chin|n.颏；下巴; v.聊天；作引体向上
never-ending|adj.不停的；无限的
vane|n.风向标；风信旗
bass|n.男低音；低音部分；低音符; adj.低沉的；低音的; n.鲈鱼
frogs|辙叉
massive|adj.巨大的；大量的；大规模的；大范围的；严重的
louder|adj.更大声的
carve|v.雕刻；切割
slippery|adj.滑的；狡猾的；不可靠的
heed|v.注意；留心; n.注意；留心
attic|n.阁楼
soap|n.肥皂；肥皂剧; vt.用肥皂洗；阿谀奉承
reflector|n.反射镜；反射体
proem|n.序文；绪言；开端
appliance|n.器具；应用；装置；器械
taro|n.芋头
lunchbox|n.便当；盒饭；午餐盒
radiatio|[医]辐射线(解)
runaway|n.逃跑者；逃亡; adj.逃跑的；失控的；迅速的
buoy|n.浮标；浮筒；救生圈；救生衣; v.使浮起；支持；鼓励；用浮标指示
triangles|三角关系
origami|n.折纸手工(日本外来语)
beet|n.甜菜根；甜菜
comer|n.来者；有成功希望的人
reread|vt.重读；再读
powdery|adj.粉的；粉状的；布满粉的；易粉碎的
rut|n.车辙；槽；凹痕；发情；陈旧不变的一套；常规; v.形成车辙；处于发情期；耕犁
three-dimensional|adj.三维的；三度的；立体的；生动的
write-in|n.选票上未列名的候选人; adj.补名选票的
gyroscopes|陀螺
millimeter|n.毫米
fibrous|adj.纤维的；纤维性的
tee|n.字母t；形状像字母T的东西; [游戏]目标.; [高尔夫球]发球的球座.; v.将（高尔夫球）置于球座
up-and-down|adj.上上下下的；起伏的；来来往往的；变动的
oceans|n.大洋
bock|n.博克啤酒（一种烈性黑啤酒）
scrape|v.刮掉；擦掉; n.擦伤；擦掉；刮擦声；窘境
wisely|adv.聪明地；精明地
highs|n.高频分量(高处)
i-|不旋；异
ceiling|n.天花板；上限
cinnamon|n.肉桂；肉桂树；肉桂色; adj.肉桂色；黄褐色的
lir|(=leftiliacregion)左髂区,(=leftinferiorrectus)左下直肌
spring-loaded|弹簧支承,受弹簧力作用
caterpillar|n.毛虫; Caterpillar.; n.卡特彼勒(财富500强公司之一；总部所在地美国；主要经营工业农业设备)
apprentice|n.学徒；见习生; v.使当学徒
orchid|n.兰花；淡紫色
microscopes|显微镜
skee|n.滑雪；滑水
odor|n.气味；名声；气息
dit|n.摩尔斯讯号的短音
vision|n.视力；视觉；幻觉；眼光；洞察力；想象力; v.幻想；设想
jaguar|n.美洲豹，美洲虎
plateau|n.高原；平稳；稳定状态; vi.到达平稳阶段
solvents|溶剂
towered|adj.高耸的(有塔的)
wrinkle|n.皱纹；方法; vt.使起皱纹；皱着; vi.起皱
riel|n.柬埔寨的货币单位
database|n.数据库
hilly|adj.多小山的；丘陵的
syrup|n.糖浆；甜而黏稠的汁液
ruin|vt.毁灭；毁坏；（使）破产；糟蹋，使（妇女）失去贞操; n.毁灭；废墟；崩溃
peep|n.瞥见；偷看；初现; n.吱吱叫; v.窥视；慢慢露出; v.吱吱叫
pollination|n.授粉
sweat|n.汗水; n.焦急；繁重工作；(凝结在物体表面的)水珠; v.(使)出汗
facial|adj.脸部的；面部的; n.美容
pa|n.爸爸
shel|n.壳层
clusters|n.簇
centimeter|n.厘米（＝1／100米）；公分
desktop|n.桌面；台式电脑; adj.台式的；桌上用的
quill|n.羽茎；大翎毛；鹅毛笔；（豪猪等动物的)刺；纬管; v.用刺刺；把(线等）绕在纬管上；打褶皱
organism|n.有机体；生物体；有机组织
edition|n.版；版本
methane|n.甲烷；沼气
emergency|n.突发事件；紧急状态; adj.应急的；紧急的；备用的
condensation|n.浓缩；凝结；液滴
raw|adj.未加工的；生的；原始的；湿冷的; n.触到某人的痛处
cob|n.玉米棒子；雄天鹅；短腿马；圆锥；柴泥灰墁
savanna|n.(非洲)大草原；无树平原
forming|n.形成(成形法；模锻); v.形成
landslide|n.山崩；滑坡；占绝对优势的选举
chunk|n.矮胖的人或物；厚块（片）；相当大的量; vt.（高尔夫球）没击中; vi.发出猛冲的声音
ctz|(=ceftezole)头孢去甲唑啉,去甲唑啉头孢菌素,(=chemoreceptortriggerzone)化学感受器触发区(延髓呕吐中枢),催吐化学感受区,(=chlorothiazide)氯噻嗪,克尿塞,(=clotrimazole)克霉唑,抗真菌1号
tot|n.小孩；（酒等）一杯；一口; v.加；合计
investigate|v.调查；研究
fin|n.鳍；鱼翅；鳍状物；散热片；五元纸币
bison|n.野牛
breathing|n.呼吸
lanterns|灯具
stepping|n.步进(通过透镜天线后波前的取平；改变)
measurement|n.测量，测量法；尺寸，尺码；大小；衡量；三围
rotation|n.旋转；循环
cargo|n.货物；船货
mushroom|n.蘑菇；菌菇状物；暴发户; vi.采蘑菇；雨后春笋般涌现；迅速增加
underline|v.在…下面划线；强调
slam|v.砰地关上；猛放；猛烈攻击; n.砰然声；猛烈抨击; n.满贯
core|n.核心；果心；要点; vt.挖去果核
sui|adj.隋(中国的一个朝代)
fleece|n.羊毛；一次剪得的羊毛；羊毛状物; v.欺诈
scavenger|n.拾荒者；食腐动物；清除剂
garter|n.吊袜带; Garter：嘉德勋章；嘉德勋位的成员.; v.用吊带系紧
classmate|n.同班同学
ma|n.妈
wrench|n.扳钳，扳手；猛扭；痛苦; vt.扭伤；挣脱; vi.猛扭；曲解
wider|adj.更宽的；更广阔的
manatee|n.海牛
soak|vt.使浸透；吸入；浸洗；使喝醉；敲竹杠; vi.浸泡；渗透；渗入；酗酒; n.浸；湿透；酒鬼
interactive|adj.相互作用的；交互的
rubber|n.橡胶；橡皮；橡胶制品; adj.橡胶的
skyscraper|n.摩天大楼
compute|v.(用计算机或计数器)计算；估计
crossword|n.纵横字谜
day-and-night|adj.夜以继日的
wick|n.蜡烛芯；灯芯
icebox|n.冰箱；电冰箱
keck|v.想吐；作呕；极为讨厌
firefighting|n.消防
soot|n.煤烟；烟尘; v.熏以煤烟
high-pitched|adj.尖声的；高声的；陡坡的；激烈的
downfield|adj.[美橄]在前场(的); adv.[美橄]在前场(的); 向前场(的).
glean|v.拾落穗；收集
outweigh|v.比...重要；比...有价值
redbud|n.紫荆属植物；美国紫荆
collapsed|adj.倒塌的
caramel|n.焦糖；焦糖糖果；焦糖色；淡褐色
resource|n.资源；机敏；才略；寄托；消遣
masses|n.平民；群众
digest|n.摘要; vt.消化；理解; vi.消化
thermometer|n.温度计
mh|n.报文处理程序
boom|n.繁荣；兴旺；激增；低沉声; n.帆杠；吊杆；支臂；尾桁；水栅; vi.急速增长；发出低沉声; vt.使兴旺；促进
hummingbird|n.蜂鸟
cheers|int.干杯；再见；谢谢
buildup|n.集结；增长；树立名誉
sprout|v.长芽；萌芽；迅速成长; n.芽；年幼者
rainy|adj.多雨的；下雨的
elodea|n.伊乐藻属植物
airports|机场
observation|n.观察；观察力；注意；评论
bucket|n.【C】水桶；（机器上的）桶装物；大量; vi.颠簸行进；下倾盆大雨; vt.装在桶里
outlet|n.出路；出口；通风口；批发商店，经销店
windsock|n.风向袋；套筒风标
five-day|adj.每周5天的
magnifier|n.放大镜；放大器；扩大者，夸大者，放大者
mathematical|adj.数学的；精确的；可能性极小的
tfc|n.交通量(运输)
straws|吸管
immune|adj.免疫的；免除的
franco|adj.免费的(邮费准免的)
chemist|n.化学家；药剂师；药房
negatively|adv.否定地；消极地；负极地
overflow|v.泛滥；溢出；充满；洋溢; n.泛滥；溢值；剩出
grill|n.烤架；铁格子；烧烤(食物); vt.拷问；(在烤架上)烤
ire|n.愤怒
mineral|n.矿物(石）；矿物质
newborns|n.新生者；新生儿
relative|adj.相对的；比较的；相关的; n.亲戚；[语]关系词
airy|adj.通风的；轻快的；幻想的；航空的
chapel|n.小礼拜堂；礼拜仪式；唱诗班；印刷厂工会；殡仪馆
statues|现状
geology|n.地质学；（某地区的）地质情况；地质学的著作
far-reaching|adj.深远的；伸至远处的；广大的
newborn|adj.新生的; n.新生儿
rotate|v.轮流；(使)旋转; adj.车轮状的
oak|n.橡树；橡木
berry|n.浆果; vi.采浆果
circuit|n.巡回；线路；环形；电路；回路; v.巡回；绕...环形
overload|v.使超载；给…增加负担；使(电脑或电路)超负荷; n.过多；超载；负荷
rust|n.铁锈；锈菌；赤褐色; vi.生锈；变成锈色; vt.使...生锈；损害
willow|n.柳树；柳木制品
gelatin|n.动物胶；明胶；凝胶
sailor|n.海员；水手；扁平的硬边草帽
sculpture|n.雕塑；雕刻; v.雕刻；雕塑；刻蚀；当雕刻师
headline|n.大字标题；新闻提要；头条新闻; v.加标题于；宣扬；作主角
seesaw|n.跷跷板；上下动; v.玩跷跷板；上下摇动
blast|n.爆炸；巨响；一阵(强风)；严厉的批评；愉快的经历; v.爆破；摧毁；发出巨响；用力撞击；批评
daylight|n.日光；白昼；黎明
mercury|n.水银；（M~）水星；精神
windless|adj.无风的；平稳的
melon|n.甜瓜
softball|n.垒球
minnow|n.鲦鱼；小淡水鱼；无足轻重的小公司；不起眼的小型运动队
piezoelectric|adj.[物]压电的
ow|int.哎哟
stiff|adj.硬的；僵直的；艰难的；生硬的；拘谨的；烈性的; adv.极其；僵硬地; n.死尸；流浪汉；过于拘谨的人；吝啬鬼；醉鬼
icy|adj.冰的；冷淡的
olla|n.土制冰瓮；什锦菜
wade|v.跋涉；涉水; n.跋涉
steadily|adv.稳定地；稳固地；逐步地
attraction|n.吸引；吸引力；有吸引力的人或事物
presto|adv.(音乐演奏)急速; adj.(音乐)急速的; n.(音乐)快拍；急速
muddy|adj.泥泞的；浑浊的；糊涂的; v.使沾上烂泥；使...混浊；使迷惑
exceptional|adj.异常的；例外的；特别的；杰出的
hike|n.徒步旅行；远足；涨价; vi.远足；提高
shrimp|n.虾；瘦小的人（物）; vi.钓虾
underbrush|n.矮树丛
tide|n.趋势；潮流；潮汐；潮水; v.渡过；（使）随潮漂流
essentia|[医][生物]要素,露,香精剂(挥发油醇溶液)
diagram|n.图解；图表; vt.用图解法表示
removes|引语排版
aw|int.表示抗议、怀疑、厌恶等的感叹语
outcome|n.结果；后果
faraway|adj.遥远的；远方的；(神情)恍惚的；出神的
comparison|n.比较；比喻
infect|vt.传染；感染
kettle|n.水壶；坑穴
low-pitched|adj.低调的；倾斜缓慢的
serge|n.哔叽(布料)
displacement|n.置换；转位；移动；位移；排水量
pulp|n.果肉；纸浆；木髓；牙髓；低级刊物; v.使成为浆状；除去...的果肉；把...制成纸浆
rake|n.耙子；耙状物; n.放荡的人; n.斜度；倾角; v.用耙子聚；收集；搜索; v.使倾斜
anthill|n.蚁冢；人密集的地方
mete|vt.量；测量；分配; n.边界；界石
wagon|n.四轮马车；货车; v.用四轮马车运
comparisons|比较
watt|n.瓦特
eople|大众
universal|adj.普遍的；全世界的；宇宙的；全体的；通用的; n.通用原理，普遍原则
roundabout|adj.绕道的；迂回的; n.环形交叉路口; n.(英)旋转木马; n.紧身短上衣
daffodil|n.黄水仙花
tarnish|n.晦暗；污渍; v.沾污
gu|(=gastriculcer)胃溃疡,(=genitourinary)生殖泌尿的,(=glucoseuptake)葡萄糖摄取,(=glycogenicunit)糖原生成单位,(=gonococcalurethritis)淋(病双)球菌性尿道炎
interaction|n.相互作用；相互影响；互动交流
reasoning|n.推论；推理；论证
gale|n.狂风；一阵（喧闹；笑声等）
ahm|n.安培小时计
faint|adj.微弱的；无力的；模糊的; v.昏倒; n.昏厥；昏倒
irregularly|adv.不规则地；不合常规地
atmospheres|n.大气圈
untested|adj.未试验的；未测试的
pala|(划蝽科)铲形跗
footprint|n.脚印；足迹
reclamation|n.开垦；收复；再利用；矫正
abbey|n.修道院；修道院教堂
mustard|n.芥末；芥菜；中棕黄色
combination|n.结合；结合到一起的事物或人；密码
surveyors|勘测人员
doppler|n.多普勒效应
ultraviolet|adj.紫外线的; n.紫外线
hn|(=halonaevus)乳晕痣,(=headandneck)头与颈,(=heller-nelson(syndrome))赫勒-纳尔逊(综合征),(=hemagglutininneuraminidase)血细胞凝集素的神经氨酸酶,(=hematemesisneonatorum)新生儿呕血,(=hemorrhagicnephrosonephritis)出血性肾变病肾炎:流行性出血热,(=hereditarynephritis)遗传性肾炎,(=hilarnode)肺门淋巴结,(=histamine-containingneuron)含组胺神经元,(=humannutrition)人体营养,(=hypertensivenephropathy)高血压性肾病,(=hypertrophicneuropathy)肥大性神经病,(=hypoglossalnerve)舌下神经
cut-out|n.断流器；保险开关
collide|vi.碰撞；互撞；砥触
lq|n.液体
grid|n.格子；栅栏；电网；网格；赛车起跑线
eclectic|n.折衷主义者；折衷派的人; adj.选择的；折衷的；兼收并蓄的
eft|n.蝾螈
overlap|vt.重叠；重复; vi.有重叠部分; n.重叠部分；重复
saws|v.锯
constantly|adv.不断地；经常地
cart|n.【C】(二轮或四轮)运货马车；手推车; vt.(用手推车)运送；(用力；粗鲁地)拖
irk|v.使厌倦；使苦恼; n.厌倦；苦恼
brag|v.吹牛；自夸; n.大话；吹牛的人；傲慢的态度; adj.一流的；特别好的
bloomed|adj.模糊的(无反射的)
insignificant|adj.无关紧要的；可忽略的；不重要的；无用的
arsenic|n.砷；砒霜; adj.砷的；含砷的
gathers|n.衣褶
fireworks|n.烟火
dow|vi.得以，能够; n.道琼斯平均指数(=DowJonesaverage)；陶氏化学（美国的一家化学公司）
cod|n.鳕鱼; v.哄骗；愚弄
sketch|n.速写；素描；草图；概述; v.草拟；速写；(简略地)描绘
preserve|v.保护；保存；保持; n.禁猎区；蜜饯
newly|adv.新近地；重新地
swamp|n.沼泽；湿地；困境; v.淹没；使陷于困境；使忙于应付
voila|int.那就是；瞧(表示事情成功或满意之感叹词用语)
mod|n.摩登派青年; v.改装(电脑设备等)
gallon|n.加仑(容量单位)
loudness|n.响亮；音量；大声
smartphones|智能手机
kang|n.炕
barometer|n.气压计；晴雨表
tine|n.齿；叉；鹿角尖
indef|adj.无限的；不定的
mud|n.泥；泥浆；诽谤; vt.弄脏；抹泥
conclusions|结论
polish|n.光泽；上光剂；优雅；精良; v.擦亮；磨光；推敲；完善; Polish.; adj.波兰的；波兰人的；波兰语的; n.波兰语
insulation|n.【物】绝缘（体）；隔离；孤立
maturity|n.成熟；(支票等的)到期
incorporate|v.合并；组成公司; adj.合并的；公司组织的
twig|n.小枝；嫩枝; v.理解；领悟
acceleration|n.加速；促进；加速度
cheetah|n.猎豹
veggie|n.蔬菜(=vegetable); n.素食者(=vegetarian)
aluminum|n.铝; =aluminium（英）.
musical|adj.音乐的；喜欢音乐的；悦耳的; n.音乐片
perfume|n.香水；香气; vt.洒香水于；使香气弥漫
skateboard|n.溜冰板(一种装有滑轮的椭圆形滑板); v.滑滑板
gemstones|宝玉石
solvent|n.溶剂；解决者; adj.有偿付能力的；有溶解力的
yeast|n.酵母；发酵剂; vi.发酵；起泡沫
backstop|n.[棒]挡球网；捕手; vt.止住；支持；作守门员
chimpanzee|n.黑猩猩
altitude|n.高度；海拔；高地
conceive|v.设想；想出；怀孕
xu|n.苏(越南货币单位)
lemon|n.柠檬；柠檬色；次品；令人讨厌的人
waw|n.希伯来语的第六个字母; =vav.
pree|vt.(尤指通过品尝的方法)尝试; 证实.
leaky|adj.出现裂缝的；泄漏的
nail|n.钉子；指甲；爪; vt.钉；抓住；使固定
beluga|n.白鲟；白鲸；鲟子酱
halfway|adj.中途的；不彻底的; adv.半路地；在…中间；折中地
potent|adj.强有力的；有效的
streamer|n.横幅；长条旗；装饰彩纸条；北极光；流光；(报纸的)通栏标题
geologist|n.地质学家
telescope|n.望远镜; v.缩短；压缩；套叠
mailbox|n.邮筒；邮箱
liberty|n.自由；自由权；冒失
hy|(=history)病史,历史,(=hyaluronicacid)透明质酸,(=hypermetropia)远视,(=hypophysis)垂体,(=hypothenar)小鱼际,(=hysteria)癔病,歇斯底里
fertilization|n.受精；施肥
sleet|n.雨雪; v.下雨雪；下冰雹
fabulous|adj.极好的；巨大的；传说中的
sned|vt.砍掉；修剪
sh|int.嘘(要别人不作声时用)
mi|n.大音阶的第三音
bristlecone|狐尾松
idol|n.偶像; n.菩萨
reunion|n.团聚；联合
crocus|n.番红花属；番红花；藏红花；磨粉
rosebush|n.玫瑰丛
scoop|n.铲子；勺；舀取；穴；独家新闻; vt.挖空；舀取；抢先报道（获得）
pAg|(=proteinAgold)蛋白A金
first-quarter|adj.第一季度
hypothesis|n.假说；假设；前提；猜测
mantle|n.斗篷；覆盖物；墙的外皮；（汽灯的）纱罩；[地]地幔; v.覆盖；笼罩；脸红
mantis|n.螳螂
sheen|n.光辉；光彩；光泽
nbi|(=neutrophilbactericidalindex)中性白细胞杀菌指数,(=noboneinjury)无骨质损伤
cooper|n.桶匠；修桶工人; v.制桶；修桶
nozzle|n.喷嘴
wafer|n.薄脆饼；圆片；[宗]圣饼；[电]薄片；晶片; v.封缄；切成薄片
yo|int.唷(水手拉绳时一道发出的叫声)
refrigeration|n.冷却；冷藏；冷冻
cubs|n.幼童军，童子军
investigations|调查
hazardous|adj.危险的；冒险的；碰运气的
improvise|v.即兴创作；即兴表演；临时准备
reem|扩缝(捻缝时把缝扩大
cement|n.水泥；纽带；接合剂；牙骨质；补牙物；基石; vt.用水泥涂；巩固; vi.接合起来
sequence|n.顺序；连续；次序；一系列; vt.按顺序排好
ripe|adj.成熟的；熟的
mechanism|n.机制；原理; n.结构；机构；机械装置
behavioral|adj.行为的
crate|n.板条箱；篓子；旧汽车; v.装进纸条箱
cub|n.幼兽；年轻人
tilt|vt.(使)倾斜; vi.抨击；争论; n.倾斜；车盖；以全速；(小舟、车辆、地摊等的)帐蓬
musty|adj.发霉的；霉臭的；落伍的
depressions|坳陷
explosivity|n.爆炸性
reptile|n.爬行动物；卑鄙的人; adj.爬虫类的
yield|v.生产；获利；屈服；弯下去; n.投资收益；生产量
typically|adv.典型地；代表性地；通常，一般；不出所料地
sunglasses|n.墨镜；太阳镜
delta|n.(河流的)三角洲；希腊语第四个字母（Δ、δ）
timely|adj.及时的；适时的; adv.及时的
low-lying|adj.地势低洼的；低标高的
woodchuck|n.土拔鼠; =groundhog.
howto|adj.基本知识的
goldenrod|n.[植]秋麒麟草属植物
pitchers|瓷渣
herbivore|n.草食动物
minority|n.少数；少数民族；未成年
cracking|n.分裂；分解; adj.很快的；很好的；很美的; adv.很快地；很好地；很美地
tray|n.托盘；盘
chameleon|n.变色龙；善变的人；轻浮的人
erode|vt.腐蚀；侵蚀；逐步毁坏，削弱，损害; vi.受到侵蚀
tere|[医]研摩(调剂用词)
confetti|n.五彩纸屑；碎花纸
two-step|n.拍圆舞；拍圆舞曲
slant|n.倾斜；斜面；个人的观点或见解；倾向性；偏见; vt.使倾斜；歪曲; vi.倾斜
counter|n.柜台；筹码；计数器；反驳; adj.相反的; adv.与…相反地; v.反对；反击
basin|n.脸盆；盆地；流域；水池
mammoth|adj.巨大的；庞大的; n.长毛象；猛犸
lek|n.阿尔巴尼亚的货币单位；其货币
afield|adv.远离着(家乡)；在或去远处；在野外
puppy|n.小狗；自负的小伙子
nil|n.无；零
quid|n.供咀嚼的烟草块；一英镑
sperm|n.精液；精子；与抹香鲸有关的物质(如鲸脑油); pref.表示“精液；精子；种子”（=spermo-；sperma-；spermi-）
fore|adj.在前的; n.前头；船头
rack|n.行李架；（放衣物、碗碟等的）架子；拷问台；折磨；（比赛开始前固定球位置的）三角框; vt.使痛苦；把...放在架子上；累计取得
puy|n.死火山锥
fuse|n.保险丝；导火线；引线; vt.熔化；融合；装导线；装引信于; vi.熔化；融合
conserve|n.蜜饯；果酱; v.保存；保持；节省；用糖保存
lizard|n.蜥蜴
operator|n.操作员；技工；管理者；报务员；【计】运算符
canvas|n.油画；帆布；（帆布）画布
oui|adv.是；是的
bacon|n.培根；咸肉；熏肉
disk|n.圆盘；唱片；花盘；磁盘；盘形物
moonlight|n.月光; v.兼职; adj.夜间的
fade|v.逐渐消失；褪色；凋谢; n.淡入；淡出
radiated|adj.有辐射棱线的；辐射的
mature|adj.成熟的；(保单）到期的；考虑周到的; v.成熟；长成
poll|n.民意测验；投票；票数; v.做民意测验；获得...票
liftoff|n.（火箭等）发射；起飞
impala|n.黑斑羚
spill|v.溢出；洒；使...流出；泄漏; n.溢出；流；木片；小杆
thf|adj.高频调谐的
hibernation|n.冬眠
liquids|液体
naturally|adv.自然地；天生地
otter|n.水獭；水獭皮
unlock|v.开锁；开启；揭开；显露
markers|标记
loosely|adv.松弛地；宽松地；不严谨地
upstream|adj.上游的；逆流而上的; adv.向上游；逆流地
necessity|n.需要；必需品；必然
harness|n.马具；安全带；甲胄；系在身上的绳子; vt.束以马具；披上甲胄；利用；管理；控制
weekly|adj.每周的；一周一次的；周刊的; n.周刊；周报; adv.每周；一周一次
one-half|n.二分之一
scoreboard|n.记分板
disagrees|不乐意
switches|n.[计算机]DOS命令:允许从101键的键盘向后兼容；及将WINA20
amphibian|adj.两栖类的；水陆两用的; n.两栖动物；水陆两用飞机；水陆两用车
qq|n.一款即时通信软件
bullhorn|n.带放大器的扩音器；鸣音器
boiling|adj.沸腾的；极热的；极其愤怒的
evaporation|n.蒸发；消失；脱水；干燥
graphics|n.制图法；绘图学; n.【计算机科学】图解计算; n.【语】书法；字体
crab|n.蟹；阴虱；爱争吵的人；[植]山楂子; v.捕蟹；使横行；批评；抱怨
esne|n.底层社会的人；奴仆
wormlike|adj.像虫的; 虫一样蠕动的.
plop|n.扑通声; v.(使)扑通掉下
dimensions|n.面积；大小；容积
kit|n.成套工具；工具箱；装备; vt.装备
grapefruit|n.葡萄柚；葡萄柚树
downward|adv.向下; adj.向下的；下降的
whew|int.(表示宽慰或惊讶)哟；唷
acacia|n.阿拉伯树胶；洋槐；刺槐；金合欢属树
rusty|adj.生锈的；荒废的；锈色的
farthest|adv.最远地; adj.最远的；达到最大程度的
cit|n.市民；便服；老百姓服装
campfire|n.营火；篝火；篝火晚会
terminal|n.末端；终点站；终点；终端机；航站楼; adj.末端的；终点的；晚期的；（每）学期的
packaging|n.包装；包装袋
marker|n.标记；做记号的工具；做记号的人；记分员
tit|n.山雀; n.乳头；乳房
firefly|n.萤火虫
sustain|vt.支持；承受；维持；认可；经受
dam|n.水坝；堤；障碍物; v.筑坝；抑制(情感等）
scrub|n.用力擦洗；矮树；渺小之物; v.用力擦洗
strip|v.剥去；剥夺；脱衣；除去; n.脱衣舞；长条；条状
filter|n.过滤器；滤色镜；滤光器; v.过滤；渗透
barge|n.驳船; vi.猛撞；冲；闯; vt.以驳船载运
orangutan|n.猩猩
pun|n.双关语; vt.说双关语
replicate|v.复制；模拟；折叠; n.复制品; adj.复制的；折叠的
porometer|气孔计
screwdriver|n.螺丝起子; n.伏特加橙汁鸡尾酒
anemometers|风速计
broom|n.扫帚；金雀花; vt.清扫
ore|n.矿石；矿
mf|n.中强
dai|Dai.; n.泰语; adj.泰语的; =Tai.
dimmer|n.调光器；车头短焦距光
soii|土壤
cattle|n.牛；家畜；畜牲
woody|adj.多树木的；木质的；森林的
windstorm|n.风暴
behaviorist|n.行为主义者；行为科学家; adj.行为主义者的；行为科学家的
pollinators|传粉昆虫
gimbal|n.平衡环；万向接头; vt.用万向架固定；装以万向接头
rail|n.栏杆；扶手；铁轨; v.抱怨；责骂；以横木围栏；铺铁轨
droop|v.低垂；下垂；(草木)枯萎；(精神)萎靡; n.下垂；消沉
shock-|adj.震动
droplets|液滴
bolt|n.门闩；螺栓；一卷布；弩箭; v.（突然）逃离；闩住；狼吞虎咽；用螺栓固定; adv.挺直地
marble|n.大理石；弹子，弹珠; vt.使有大理石的花纹
sax|n.[乐]萨克斯管；石板斧
inquiry|n.调查；询问；打听；查问; =enquiry(英).
fog|n.雾；朦胧；迷惑; v.以雾笼罩；使模糊；迷惑
nibble|v.一点点地咬；轻咬；吹毛求疵；（审慎地）表示有意接受; n.轻咬；少量
encyclopedia|n.百科全书
rhino|n.(非正式）犀牛; n.钱；现金
breaker|n.浪花；破坏者；断路器
molt|n.换毛；脱皮；换毛期; v.换毛；脱皮; =moult(美).
gill|n.鳃；菌褶；及耳(液量单位）; v.用刺网捕鱼；被缠在刺网中
decomposer|n.分解器；腐生物
lettered|adj.精通文学的；有学问的；有教育的
sesame|n.芝麻
leaflike|adj.像叶子的；成薄片的
similarity|n.相似；类似
organizer|n.组织者；备忘记事本
graph|n.图表；示意图; vt.(以图表)表示
resistance|n.抵抗；抵触；反对；阻力; n.[电]阻抗
sediment|n.沉淀物
back and forth|来回地；反复地
tz|[域]Tanzania,坦桑尼亚
billboard|n.广告牌; vt.宣传
roadrunner|n.走鹃(墨西哥、中美洲鸟名)
windowsill|n.窗沿；窗台
third-quarter|n.第三季
input|n.投入；输入信息；输入数据；信息输入端; v.输入
lobster|n.龙虾; v.捕龙虾
cutter|n.裁剪者；切割器；快艇；小艇；轻便雪橇
pedal|n.踏板；乐器的脚踏键; v.用脚踏动；踩踏板
reproductive|adj.复制的；生殖的; n.(尤指群居昆虫的)母体
roboticist|n.机器人专家
revise|n.校订；修正；再校稿; v.校订；修正；校正
exert|vt.运用；施加
current-carrying|n.载流
inn|n.客栈；小旅店
canyon|n.峡谷
mu|n.希腊字母第12个字母
flexible|adj.柔韧的；灵活的；易弯曲的；可变通的
define|v.规定；限定；定义；解释
pan|n.平底锅；盘子；盘状物；淘盘；脸；严厉批评; v.严厉批评；（用淘盘）淘金
powder-like|adj.粉状的
detect|v.发觉；察觉；探测
battery|n.电池；一系列；炮兵连；排炮；[律]殴打
sada|萨达棉平布
statue|n.雕像；塑像
intermediate|adj.中间的；中级的; n.中间体；调解人；媒介物; vi.调解；干涉
wat|n.(泰国等的)佛寺；寺院
cone-bearing|adj.松类的；结球果的
rider|n.骑士；附件；扶手
plank|n.厚板；支撑物；政纲条目; vt.铺板；用力放下；立即付钱
identification|n.确认；鉴定；识别；身份的证明
porcupine|n.豪猪；箭猪
valid|adj.有效的；有根据的；合法的；正当的
jar|n.广口瓶；坛子；刺耳声；震动; vi.发刺耳声；不协调；震荡；冲突; vt.扰乱；震动
symmetrical|adj.对称的
swampy|adj.沼泽似的；沼泽地的
gay|n.同性恋(多指男同性恋）; adj.快乐的；鲜艳的；放荡的；同性恋的
campout|野营,露营生活
earliest|n.最早; adj.最早的
mou|n.亩
destructive|adj.破坏性的；有害的
nonrenewable|adj.不可再生的
clump|n.丛；块；沉重的声音; v.用沉重的脚步行走；丛生；使成簇
powder|n.粉末；粉；火药；细雪; vt.洒粉于；使变成粉；重击; vi.变成粉；涂粉
cloth|n.布；布料；一块布
fast-moving|adj.移动迅速的；情节紧凑动人的
hemisphere|n.半球
thickness|n.厚度；浓度；层
recreation|n.消遣；娱乐
watery|adj.(似)水的；含水过多的；潮湿的；苍白暗淡的
connection|n.联系；关系；连接；亲戚
wire|n.金属丝；电线；电报; vt.发电报；装电线；(通过电线)接通；用金属丝把...连一起；电汇
separation|n.分离；分居；缺口；分隔线；[化]离析；【航】间隔
identical|adj.同一的；相同的
monarch|n.帝王；统治者；君主; n.君王斑点蝶
wk|n.星期(工作；加工制造)
flea|n.跳蚤
pigment|n.色素；颜料; v.把...加颜色；变色
cork|n.软木塞；软木树；软木
beaver|n.海狸；獭皮(帽)；女性生殖器; n.护面甲; vi.卖力地工作
magnetic|adj.有磁性的；有吸引力的；催眠术的; n.磁体，磁性物质
potassium|n.钾
magazines|杂志
rime|n.白霜; v.使蒙上霜
goldfish|n.金鱼
lip|n.嘴唇；唇状物; v.接吻；说话；拍打
py|[域]Paraguay,巴拉圭
incorrectly|adv.不正确地；错误地
aerosols|气溶胶
rage|n.狂怒；大怒；狂暴；肆虐；风行; v.大怒；怒斥；激烈进行；肆虐
refuge|n.避难；避难所；庇护; v.庇护；避难
repeatedly|adv.重复地；再三地
segments|n.段
roadways|回采巷道
grab|v.抓住；攫取; n.抓取物；抓
squeeze|v.挤压；塞进；压榨；设法腾出; n.挤压；少量；拥挤；严控；财政困难
neatly|adv.整洁地；熟练地
mimosa|n.含羞草
predator|n.食肉动物；掠夺者；（动物的）捕食性天敌
nonliving|adj.无生命的；非活体的
macaw|n.金刚鹦鹉
rip|v.撕裂；扯开; n.裂口；裂缝；撕裂
horse-drawn|adj.马拉的
coastline|n.海岸线
e-|[前缀]为ex-之变体
bahr|水体,深泉水
snorkel|n.水下通气管；通气管; vi.用通气管潜航
organizing|vbl.组织；编制；使有机化
land-based|adj.以地面为基地的
quest|n.探索；寻求; v.寻找；搜索
static|adj.静态的；静止的；稳定的；静力的；静电的; n.静电；静电干扰
instinctively|adv.(出于)本能地
ume|n.梅花; Ume; n.于默河（瑞典北部一河流）
spacecrafts|航天器
harden|v.(使)变硬；(使)坚强
evaluate|vt.评价；评估
withstand|vt.对抗；经得起；承受
scab|n.痂；疥癣；破坏罢工者；[俚]无赖; v.结疤；破坏罢工
testable|adj.可试验的
tally|n.帐；记分；一致；标签; vt.计算；记录；使一致; vi.计算；记分；一致
bonus|n.红利；意外所得之物；奖金；【篮】追加罚篮
greenish-blue|adj.蓝绿色的
speeding|adj.高速行驶的; n.超速行驶
trampoline|n.蹦床；弹床
electromagnet|n.电磁石；电磁体
closed-circuit|adj.闭路式的
utility|n.效用；实用；公用事业（费）；[计]应用程序; adj.多效用的；多功能的
analyze|vt.分析；解析；研究
grassland|n.牧场；草地
stratus|n.层云
pollen|n.花粉; vt.授粉给
wholewheat|n.全麦
widen|vt.加宽；使变宽；扩大; vi.变宽
curl|n.卷曲；卷发；年轮；漩涡；[足]曲线球; vt.弄卷；使弯曲; vi.变卷；弯曲
wingspan|n.翼幅；翼展
yup|adv.是的；对啊(=yep); n.雅皮士
decompose|v.分解，拆分，拆解；腐烂
hypothesize|v.假设；假定；猜测
rapids|n.急流；湍流
fusion|n.融合；结合；熔合；核聚变
neighborhoods|生活社区
nasty|adj.下流的；严重的；令人不快的；难懂的；危害的
lyear|n.光年
leash|n.(系狗的)皮带；控制；约束; n.（打猎用语）三只；三个一组; v.用皮带控制；束缚
gas-|气；气体
inactive|adj.不活动的；停用的；怠惰的
carvings|雕刻品
sharpener|n.卷笔刀；研磨者；研磨工具
composed|adj.镇静的；沉着的；由…组成的
goto|转到
mesquite|n.(=mesquit)豆科灌木
encounter|n.意外的相见；邂逅；遭遇; v.遭遇；遇到；偶然碰到
mixed-up|adj.头脑不清楚的；迷惑不解
glossary|n.词汇表；术语汇编
sea-based|adj.海基的
magnet|n.磁铁；有吸引力的人（物）
leatherback|n.大海龟之一种
debris|n.碎片；残骸
bud|n.芽；花蕾; vi.发芽；萌芽; vt.使发芽
cocoon|n.茧；茧状物; v.包围；包裹
hatching|n.阴影；影线
rotary|adj.旋转的; n.旋转式机器；环形交叉路
cuplike|adj.杯形的
sweatshirt|n.运动衫
wool|n.羊毛；毛线；毛织品
crack|v.破裂；砸开；发出爆裂声；撞击；破解；变嘶哑；崩溃；制裁；开玩笑; n.裂缝；裂痕；爆裂声；猛击；尝试；俏皮话; adj.训练有素的
crescent|n.新月；新月形之物; adj.新月形的；逐渐增加的
sled|n.雪撬
bloom|n.花；开花；最佳时期；花期; v.开花；繁盛
onit|[化]渥尼脱;翁尼特;环三亚甲基三硝胺
driveway|n.(住宅前的)车道
mist|n.雾；迷蒙；朦胧不清; vt.使…模糊；蒙上雾; vi.使模糊；下雾
slow-moving|adj.动作缓慢的；滞销的
|/DTDXHTML1.0Transitional//EN""http://www.w3.org/TR/xhtml1/DTD/xhtml1-transitional.dtd">$(function(){setTimeout("location.href='https://dict.cn'",6000);});404页面varcur_dict='404';vari1_home='https://i1.haidii.com';varxuehai_home='https://xuehai.cn';varpassport_home='https://passport.dict.cn';varcrumb='',dict_homepath='https://dict.cn',hc_jspath='https://i1.haidii.com/v/1560739479/i1/js/hc3/hc.min.js',use_bingTrans='',multi_langs='';var_hmt=_hmt||[];(function(){varhm=document.createElement("script");hm.src="https://hm.baidu.com/hm.js?c02099862d294e963ee04d8f8a6f204f";vars=document.getElementsByTagName("script")[0];s.parentNode.insertBefore(hm,s);})();.nav-1lia.currents{padding:8px8px8px;border:none;}#header.links.top-downloada{width:140px;height:40px;line-height:normal;background:url(https://i1.haidii.com/v/1493890436/i1/images/top-download-icon2.png)00no-repeat}#header.links.top-downloada:hover{background:url(https://i1.haidii.com/v/1493890436/i1/images/top-download-icon2.png)0-40pxno-repeat}海词权威词典翻译varpagetype='';Oops!这个页面不存在！404errorpage6秒之后自动跳转到首页海词英语背单词词典生词本关于海词-版权声明-联系海词-星级词汇-汉字列表-招贤纳士&copy;2003-2021海词词典(Dict.CN)-自2003年11月27日开始服务&nbsp;沪ICP备08018881号&nbsp;&nbsp;沪公网安备31011502000490号海词词典手机移动站varlangt='';varcur_dict='404',i1_home='https://i1.haidii.com',xuehai_home='https://xuehai.cn',passport_home='https://passport.dict.cn';var$dict_id='';var$dict_query='';var$dict_dict='';varscb_home='https://scb.dict.cn';var$dict_ver='1621078955';varsugg_home="https://dict.cn/apis";varcur_dict='404',i1_home='https://i1.haidii.com',xuehai_home='https://xuehai.cn',passport_home='https://passport.dict.cn',$dict_id='',$dict_query='',$dict_dict='',$user_id='',$dict_ver=1608199947;var_gaq=_gaq||[];_gaq.push(['_setAccount','UA-138041-2']);_gaq.push(['_setDomainName','dict.cn']);_gaq.push(['_trackPageview']);(function(){varga=document.createElement('script');ga.type='text/javascript';ga.async=true;ga.src=('https:'==document.location.protocol?'https://ssl':'http://www')+'.google-analytics.com/ga.js';vars=document.getElementsByTagName('script')[0];s.parentNode.insertBefore(ga,s);})();
electronics|n.电子学；电子器件
conditioner|n.调节器；调节装置；护发素
vill|欧洲封建时代的行政区域(相当于现代的镇)
fossils|化石
clumsy|adj.笨拙的；不得体的；笨重的
varying|adj.不同的
sponge|n.海绵; vt.用海绵擦拭；吸收掉；抹掉
den|n.兽穴；集聚地; v.穴居
hot-air|adj.热空气的
ver|n.[计]显示当前DOS版本号(DOS命令)
neutral|adj.中立的；中性的；空档的；素净色的; n.中立者；空挡位置
sue|vt.控告；起诉; vi.请求；起诉
cuckoo|n.杜鹃；杜鹃的叫声; v.像杜鹃一样咕咕叫; adj.愚蠢的；疯狂的
metric|adj.公制的；米制的；十进制的; n.标准；度量
situations|现状
nonvascular|非血管性的
groundwater|n.地下水
condenses|v.浓缩；压缩；精简; 动词condense的第三人称现在时.
rainforest|n.雨林
lid|n.盖子；眼睑; vt.给...装盖子
mahogany|n.红木；桃花心木；赤褐色; adj.红褐色的
analyst|n.分析家
non|adv.[拉]非；不是
elliptical|adj.椭圆的；省略的；简要的
mow|v.割（草、麦等）；刈；扫射；扮鬼脸; n.草堆；谷物堆；鬼脸
toa|帮派间的义气
udo|n.[植]土当归
retain|vt.保持；保留；记住；聘请
crumble|v.崩溃；弄碎；破灭
stalk|n.茎；梗; n.跟踪；高视阔步; v.悄悄靠近；跟踪；蔓延；高视阔步地走
uninhabited|adj.无人居住的；杳无人迹的
conduction|n.传导；输送
bull|n.公牛；股市看涨的人；警察; n.荒谬的话; n.教皇诏书; adj.公牛的；鲁莽的
multiplication|n.增加；繁殖；乘法运算
ang|(=angiogram)血管造影照片,(=angiotensin)血管紧张素,(=angleofthescapula)肩胛角,(=angle)角,(=angulation)角度
trait|n.特征；特点；少许；一笔
tyrannosaurus|n.[古生物]暴龙
inference|n.推理；推论；推断；结论
copper|n.铜；铜币；警察；紫铜色；有紫铜色翅膀的小蝴蝶; vt.镀铜
pita|n.(中东地区和南美的)皮塔饼；龙舌兰；龙舌兰纤维
royalty|n.皇家；皇族; n.版税
ooze|v.（使）渗出；泄漏；流露; n.软泥；渗出物
boar|n.野猪；公猪
label|n.标记；标签；称号；唱片公司; vt.贴标签于；把...归类
relate|v.叙述；使有联系；有关联；涉及；符合；发生共鸣
sorts|n.种类; 分类.
two-layer|n.两层
finite|adj.有限的
rulers|尺子
detergents|除污剂；去污剂
sneak|vt.偷偷摸摸做; vi.偷偷地走；偷偷地做; n.鬼鬼祟祟的人；潜行；溜; adj.出其不意的；暗中进行的
summarize|v.概述；摘要而言
behaviors|行为
swivel|n.转换仪器；转体; v.(使)旋转
stinky|adj.恶臭的
stove|n.炉子；窑；【主英】温室
unreliable|adj.不可靠的
shrink|vi.收缩；退缩；萎缩；畏惧，害怕; vt.使收缩; n.收缩；萎缩; n.精神科医生
poh|int.轻视之声; vt.使疲倦
beam|vi.微笑；发光; vt.播送；发射；用梁支撑; n.桁条；光线；(光线的)束；(横)梁
probe|n.调查；查究；探针；探测器; v.用探针测；探测；详细调查
erupt|v.爆发；喷发；发疹
moss|n.苔藓；泥沼; vt.使长满苔藓
palm|n.手掌；棕榈; vt.把...藏于掌中；诓骗某人
molded|模塑的
urn|n.瓮；罐；骨灰盒
spruce|n.赤松；云杉；虎尾枞属的植物; adj.干净的；外表俏丽的; vi.打扮; vt.打扮自己
rearrange|v.重新安排；重新排序；重新布置
teaspoon|n.茶匙；小匙
skyscrapers|摩天楼
josh|v.说笑；戏弄; n.无恶意的戏虐；玩笑
subtraction|n.减法；减去
chamber|n.室；会议厅；房间; adj.【音】室内的，小型的；私人的，秘密的
explosion|n.爆炸；爆炸声；激增；爆发
year-round|adj.整年的；一年到头的; adv.整年地；一年到头地
pail|n.桶；一桶之量
multistep|adj.多级的
minnows|鲰
dishwashing|n.清洗碗碟; adj.洗碗碟的；用于洗碗碟的
spicy|adj.辛辣的；香的
moose|n.麋；驼鹿(单复同)
ulg|通用逻辑门
tongue-tied|adj.张口结舌的；结结巴巴的；讲不出话的
radar|n.雷达
blizzard|n.暴风雪；大量; n.暴雪（美国游戏软件制作公司）
shaft|n.柄；竖井；杆状物；矛；轴；（一道）光线; vt.苛刻地对待；装杆于
vitamin|n.维生素
ku|n.鼓
ocg|(=omnicardiogram)全心动描记图,(=omnicardiograph)全心动描记器,(=oralcholecystogram)口服胆囊造影照片,(=oralcholecystography)口服胆囊造影术
mouthpiece|n.(电话)送话口；(乐器)吹口；喉舌
magma|n.岩浆；糊剂
jm|[域]Jamaica,牙买加
magnify|v.放大；夸大
exception|n.例外；不合规则；反对；[律]异议
air-conditioned|adj.备有空调装置的；装有冷暖气机的
depth|n.深度；深刻；深奥；深；厚度
rearing|饲育
fragrance|n.香味
scarce|adj.缺乏的；不足的；稀少的；罕见的; adv.勉强
hiss|n.嘘声；嘶嘶声; v.发出嘘声（表示不满）；发嘶嘶声
p-|[医]对[位](化学)
triangle|n.三角(形)
simpler|adj.简单的；单纯的
aja|阿哈；n.；英国业余柔道协会
porch|n.门廊
moderate|adj.适度的；温和的；稳健的；中等的; v.节制；使...稳定，使...缓和; n.稳健的人
atmospheric|adj.大气的；大气层的；制造气氛的
heart-shaped|adj.心形的
xn|=exnew(shares)无新股票权
electricians|电工
sailors|海员
firewood|n.柴火；木柴
tremendous|adj.巨大的；惊人的
reservoirs|n.储集层；储存器；水库
undergo|vt.经历；经受；遭受
oily|adj.含油的；像油的；油腔滑调的
forceps|n.[医]钳子；镊子
breeze|n.微风；轻而易举的事；焦炭渣; v.飘然而行；轻松通过
node|n.节；瘤；结节；(戏剧情节的)曲折或纠纷; [计算机]节点.
habitats|生境
droplet|n.小滴；微滴
lea|n.草地；草原
vascular|adj.血管的；脉管的；充满活力的
opossum|n.负鼠；袋貂
ash|n.灰；灰烬; n.白蜡树；白蜡木; (复)ashes：骨灰；废墟；苍白.
ah|int.啊；哈; =aah.
overripe|adj.过熟的；衰萎的；颓废的
someday|adv.有朝一日
feedback|n.反馈；反馈意见
profession|n.职业；声明；行业；信仰
oracle|n.神谕；神谕处；传达神谕的人；能提供可靠意见的人
meadow|n.草地；牧场
grind|v.磨；压迫；碾碎；磨得吱吱响；逐渐停顿; n.苦事；磨；碾
garth|n.鱼梁；中庭；庭院
sip|n.啜饮; v.啜饮；啜
transform|vt.改变；转换; vi.改变；变形；变态
raisins|(无核)葡萄干
resistant|adj.抵抗的；反抗的
crispy|adj.卷曲的；脆的；易碎的；爽快的
roughly|adv.粗略地；大约；粗暴地；粗糙地；粗鲁地
flukes|锚爪
depart|vt.离开; vi.离开；死亡
barrel|n.桶；枪管；一桶的量；炮管；大量；笔管；汽油桶; vi.快速移动; vt.把...装桶
fir|n.枞树；冷杉；枞木
diameters|直径
contaminate|vt.弄脏；污染
boot|n.靴子；猛踢；解雇；[英]汽车行李箱; vt.踢；穿靴子；逐出；启动(计算机)
mam|n.妈妈(=mamma)
particle|n.颗粒；微粒；极小量；质点；粒子；[语]小品词
seedless|adj.无核的；无籽的
hive|n.蜂房；蜂箱；蜂群；喧闹繁忙的场所; vi.蜂进入蜂箱；聚居；把一部分分离出来; vt.使蜂入箱；储备
nucleus|n.核；核心；细胞核；原子核
noteworthy|adj.值得注意的
mitten|n.【C】连指手套; n.求婚拒绝
traitor|n.叛徒；卖国贼；出卖朋友者
wispy|adj.小束的；细微的；模糊的
one-fourth|num.四分之一
la|n.A音的唱名；第六音; int.啊呀；呀
prop|n.支柱；支持者；倚靠人; n.道具; n.螺旋桨；推进器; v.支撑；维持
dose|n.剂量；一剂；一服; vt.给...服药
super-cooled|过冷
thunder|n.雷；雷声; v.打雷；轰隆地响；大声喊出
airless|adj.不通风的；缺少新鲜空气的
swimmers|白色有光绒面呢
typewriter|n.打字机
dimension|n.尺寸；次元；容积；维度；范围；方面; vt.标尺寸；形成...尺寸
glow|n.光辉；热情；赤热; vi.发红光；红光焕发
zap|v.击溃；射杀；快速移动; n.精力；活力; int.嚓(表示枪声等）
vine|n.藤；蔓；攀爬植物
obsidian|n.黑曜石
nursery|n.托儿所；保育室；苗圃
processing|n.进程；步骤；数据处理；整理；配制
knob|n.旋钮；把手；瘤；节；圆丘
combing|n.梳毛; =coaming.
radish|n.（小）萝卜
pogo|n.弹簧单高跷
heavier|adj.更沉重的；更巨大的
enable|vt.使能够；使可能
fort|n.堡垒；要塞
vibration|n.震动；颤动
camouflage|n.伪装；掩饰；迷彩服; v.伪装；欺瞒
strap|n.皮带；带子; vt.(用带子)捆扎；(用带子)抽打
consumer|n.消费者；用户；消费品
freshwater|adj.淡水的；内河（航行）的; n.淡水
wax|n.蜡；蜂蜡; vt.(用蜡)涂; vi.变圆
huddle|n.杂乱一团；混乱；拥挤; v.推挤；乱堆；草率了事
thermos|n.热水瓶
uron|乌龙(交链剂)
uneven|adj.不平坦的；不均匀的；奇数的；不规律的
flour|n.面粉；粉末; v.研成粉末；撒上粉
crocodile|n.鳄鱼
glacier|n.冰河；冰川
electronically|adv.电子地；通过电子手段
atter|n.溃疡中流出的腐烂物质
clans|士族
removal|n.移动；搬迁；除去；开除
stable|adj.稳定的；安定的；可靠的; n.马棚；马厩；一批人; v.使（马）入厩；入马棚
precipitation|n.仓促；急躁；沉淀；降雨量；坠落；凝结；冰雹
distribute|v.分配；散发；分布
household|n.家庭；户; adj.家庭的；家喻户晓的
pedometer|n.步数计；步程计
sprinkler|n.洒水装置；洒水车
vapor|n.蒸汽；水蒸汽; v.蒸发；汽化
imprint|vt.刻上记号；加特征；盖印；铭记; n.印记；痕迹；特征；印象
moth|n.蠹；蛾
pesticide|n.杀虫剂；农药
lynx|n.山猫；猞猁
magnitude|n.大小；重要；光度；（地震）级数；（星星）等级
paint|v.油漆；绘画; n.油漆；颜料；绘画作品
vinegar|n.醋
shady|adj.荫凉的；可疑的
ure|抱朴说
pul|n.普尔(阿富汗货币单位)
carriages|车辆
purchase|vt.购买; n.购买；购买的物品
stoves|【机械工程；照明；加热；武器；爆破】火炉
proton|n.质子
disposal|n.处理；处置；布置
colossal|adj.巨大的；异常的
developmental|adj.发展的；进化的；开发的
friction|n.摩擦；摩擦力；分歧
phase|n.相位；方面；局面；阶段；时期; vt.逐步执行
loosen|vt.松开；放松；放宽; vi.变松；松弛
width|n.宽度；广度；宽阔
tails|n.(硬币的)反面
hurricane|n.飓风；暴风
infer|vt.推断；猜测；暗示; vi.作出推论
ethanol|n.乙醇
drain|v.排出；排干；喝光；耗尽; n.下水道；消耗
holder|n.持有者；支持物
gel-like|adj.胶样的
foil|n.钝头剑；箔；陪衬物；（击剑运动用的）花剑; vt.挫败；击退；阻挠
red-hot|adj.炽热的；近期的
underside|n.下面；阴暗面
category|n.种类；类别；范畴
thaw|n.融雪; v.使融解；暖和
xon|发送朴通
lo|int.瞧!；看！
grasshopper|n.蚱蜢；蝗虫；轻型飞机；蚱蜢鸡尾酒
handlebar|n.手把
kat|n.阿拉伯茶(产于非洲和阿拉伯); =khat.
milliliter|n.毫升；千分之一公升
doorknob|n.球形门把手
stormy|adj.暴风雨的；激烈的；粗暴的
first-aid|adj.急救的；急救用的
deni|十数的
fiz|n.发嘶嘶声；有泡沫的饮料; v.作嘶嘶声
shock-absorbing|adj.吸震的
mica|n.[矿]云母
estimate|n.估价；估计; v.估计；估价；评价
litter|n.垃圾；杂乱；一窝(幼仔)；褥草；轿子; v.乱丢垃圾；弄乱；产(幼仔)；用草等给动物铺窝
tundra|n.苔原；冻土地带
suction|n.吸；吸入；吸水管; v.抽吸；吸出
mat|n.垫子；席子; v.编织；集结；铺席于...上
irrigation|n.灌溉；[医]冲洗
watershed|n.流域；分水岭；转折点
prog|n.(非正式)相当于program；(掠夺来的)食物; v.掠夺
wasteful|adj.浪费的；挥霍的
landforms|地形
phonetic|adj.语音的；语音学的
metallurgists|冶金学家
solutions|n.解答
construct|vt.建造；构筑；造(句); n.构想
cottonwood|n.[植]三角叶杨；棉白杨; Cottonwood.; n.科顿伍德河(美明尼苏达州河流名)
audio|adj.声音的；成音频率的; n.音频；音响设备
bronze|n.青铜；青铜色；青铜制品；铜牌; adj.青铜制的；青铜色的; vt.使成青铜色
dairy|n.牛奶场；乳品店；乳制品；地方小店; adj.牛奶的；乳制品的
cypress|n.丝柏；丝柏木
zodiac|n.黄道带；十二宫图
freshness|n.新鲜；精神饱满
flip|vt.掷；轻击；弹; vi.翻转; n.（跳水或体操动作中的）空翻；轻弹；浏览; adj.无礼的；冒失的；轻率的
bloodstream|n.血流
kris|n.(马来西亚和印尼的)波壮刃短剑; =creese.
iso-|表示“相等的,相同的”之义(元音前作is-)
niece|n.侄女；外甥女；教士的私生女
minke|明克；n.；小须鲸的一种
rev|v.发动机旋转；加快速度; n.发动机的旋转
lame|adj.无说服力的；跛足的; vt.使...成残废; n.金属薄板
landform|n.地形；地貌
used-up|adj.精疲力竭的；疲惫不堪的
germination|n.发芽；萌芽；共生；晶核化
humid|adj.潮湿的
vn|[域]Vietnam,越南
hydrogen|n.氢
caption|n.说明文字; v.给（图片、照片等）加说明文字
electrons|电子
shortage|n.不足；缺少，短缺
trey|n.(牌、骰子上的)三点；有三点的牌
unmixed|adj.未混杂他物的；纯粹的
aerosol|n.浮质；喷雾剂；气溶胶
fiery|adj.火的；炽热的；激烈的；暴躁的；辛辣的
minor|adj.轻微的；较小的；次要的; n.未成年人；辅修科目；[音]小调; v.辅修
jetty|n.码头；突堤；防波堤; v.伸出; adj.黑玉般的；墨黑的；漆黑的
voltage|n.电压
woolly|adj.毛茸茸的；羊毛制的；混乱不清楚的; n.羊毛制品；羊
sliver|n.裂片；细长条；梳棉; v.(使)成小片；剖成长条
paperclip|n.纸夹；曲别针，回形针
robotics|n.机器人学
yum|int.极好的；妙的；美味的；滋味好的
auger|n.螺丝钻；钻孔机
dine|v.用正餐；进餐
dolphin|n.海豚
toucan|n.巨嘴鸟；犀鸟
microscope|n.显微镜
subsoil|n.下层土；底土; v.翻起...的底土
real-world|adj.现实的；实际生活的
fulcrum|n.（杠杆的）支点；支柱；最重要的部分
sloth|n.树獭；懒惰
scribble|v.潦草地书写；乱写; n.潦草的写法
indoor|adj.户内的；室内的
dishwasher|n.洗碟机；洗碗工
hydroelectric|adj.水力发电的
survivor|n.幸存者
compress|vt.压缩；压榨; n.[医]敷布
vacuum|n.真空；真空吸尘器；空白; adj.产生（利用）真空的; v.用吸尘器打扫
birdman|n.捕鸟者；鸟类学家；飞行家
elm|n.榆树；榆木
synthetic|adj.合成的；人造的；综合的；虚伪的; n.合成物；人工制品
charcoal|n.木炭；炭笔
hail|n.冰雹; vi.下冰雹; vt.招呼；喝彩；宣称；来自; n.欢呼
yuck|int.呸；啐（用以表示厌恶或反感等）; =yuk
mimicry|n.模仿；(动物等)拟态伪装
myth|n.神话；虚构的故事
rectangle|n.长方形；矩形
lam|v.打；鞭笞；脱逃; n.逃亡
bulldozer|n.推土机；欺凌者
forecaster|n.(天气)预报员；预测者
caddis|n.石蚕(鱼饵)；精纺毛纱编带
brine|n.盐水；海水
breakdown|n.崩溃；故障；衰弱；分类，明细；跺脚曳步舞
metallurgist|n.冶金家；冶金学者
lining|n.衬里；内层
revolve|v.旋转；考虑；围绕
skateboarder|滑溜冰板的人
hamburgers|n.麦当劳公司的股份(证券；纽约B364证券交易市场行业用语)
replica|n.复制品
um|int.嗯
brightly|adv.生辉地；明亮地；鲜明地
similarly|adv.相似地；类似地
axis|n.轴；中枢
pulse|n.脉搏；脉冲；[植]豆类; v.搏动；跳动
chide|vi.斥责；指责; vt.(温和地）责备
stat|n.静力学；站；固定的；统计的；统计学；定子；雕刻家
achievement|n.成就；成绩；完成；达到
honeycomb|n.蜂窝；蜂窝状物; v.使布满小孔；成蜂窝状
anemometer|n.风速计；风力计
cumulonimbus|n.积雨云
m-|[化]间位,[医]间位(化学名用)
disasters|灾害
loot|n.掠夺品；赃物；钱; v.掠夺；洗劫
chlorophyll|n.叶绿素
dissolve|vt.使溶解；解散；消除；解决(问题)；使沮丧; vi.溶解；液化；消散；变得模糊; n.叠化画面
milkweed|n.[植]马利筋；乳草属植物
convection|n.(热的)对流
crouch|v.蹲下；屈膝; n.蹲伏；蜷缩
vase|n.花瓶
clay|n.黏土；泥土
catfish|n.鲶鱼
silt|n.淤泥; v.(使)淤塞
anchor|n.锚；锚状物；依靠；新闻节目主播；压阵队员; v.抛锚；停泊；用锚系住；担任（广播电视新闻节目）的主持人
astronomer|n.天文学家
nearest|adj.最近的
observatory|n.天文台；气象台；了望台
apparel|n.衣服；装具; vt.装饰；使...穿衣
farther|adj.更远的；较远的; adv.更远地；进一步地
uhp|n.超高压的
adulthood|n.成年
bedtime|n.就寝时间
instinctive|adj.本能的；天性的；直觉的
gymnast|n.体操运动员
saguaro|n.巨人柱（仙人掌之一种）
nin|n.尼恩（法裔的美国作家）
eau|n.(法)水；水似的溶液
chick|n.小鸡；少妇; adj.胆小的；懦弱的
en|n.半方；N字; prep.作为；一起；在...中
horn|n.喇叭；触角；角质；号; v.强行介入
wilt|v.（使)枯萎；（使)萎靡; n.枯萎；憔悴
nit|n.虱子；没用的人
radiation|n.辐射；放射线
concluding|adj.结束的
microphone|n.麦克风；扩音器
stack|n.堆；一大堆；【计】存储栈；迭式存储器，栈式存储器；存储栈数据; v.堆积；堆放
daytime|n.白天；日间
laundry|n.洗衣店；洗衣；要洗的衣服
picks|精选
ajm|磨料喷射加工
slot|n.狭缝；槽；投币口；时间段；职位；（鹿的）足迹; v.插入；留细长的孔；放置
aspirin|n.阿斯匹林
stamen|n.[植]雄蕊
forecasting|预测
icicles|n.结晶纯可卡因(毒品相关用语)
three-fourths|四分之三
overgraze|vt.使过度放牧；在…上过度放牧
rapidly|adv.迅速地；很快地
meteorologist|n.气象学家
readily|adv.容易地；迅速地；乐意地；欣然
watertight|adj.不漏水的；无懈可击的
cone|n.圆锥体；锥形物；球果; vt.变成锥形
migrate|vi.迁移；迁徙；转移
irrigate|vi.进行灌溉; vt.灌溉；[医]冲洗
wheel-and-axle|adj.轮轴的；差动滑轮的
predictions|预言
brick|n.砖；砖块；砖状物; vt.用砖围砌（或堵）
frond|n.蕨叶；叶状体；藻体
lightweight|adj.轻量级的；无足轻重的；比较轻的; n.轻量级拳击运动员；无足轻重的人或物；轻便
meteoroid|n.流星体
explanation|n.解释；说明
thrive|vi.兴旺；繁荣；茁壮成长
tangy|adj.强烈的；扑鼻的；有刺激性的
light-weight|adj.轻量
clash|n.冲突；抵触；撞击声; vt.使…发出撞击声; vi.引起冲突
kelp|n.巨藻；海草灰
obtain|vt.获得；得到; vi.流行；通用；存在
downhill|adv.向山下；走下坡路地; adj.下坡的；向下的
birdbath|n.水盆
observable|adj.可观察到的；值得注意的；可遵守的; n.[物]可观察量(观察符号)
proof|n.证明；证据；校样; adj.防...的；耐...的; vt.检验；给...做防护措施
ine|(=individualnoiseexposure)个体噪声暴露,(=infantilenecrotizingencephalomyelopathy)婴儿坏死性脑脊髓病
gauge|n.测量仪器；测量标准；（铁道的）轨距；（钢丝等的）直径；（枪管的）口径; v.估计；判断；测量
jad|n.深长的掏槽；石面截槽
vee|n.V字形物；字母V
monitor|v.监视；监督；监听; n.班长；监视器；监听员；[计算机]显示器
pepperoni|n.意大利香肠
finis|n.终结；结束
derrick|n.动臂起重机；油井架吊杆；进线架；飞机的起飞塔
arrow|n.箭；箭头
mmmm|int.嗯；呣
ljm|液体喷射加工
edit|vt.剪辑；编辑；校订
three-fifths|num.五分之三
speedy|adj.快速的；高速的；迅速的；敏捷的；立即的
cycads|苏铁
dormant|adj.休眠的；睡眠的；静止的；潜伏的；匿名的；（动物等）冬眠的
clam|n.蛤；沉默寡言的人; vi.保持沉默；挖蚌
offish|adj.冷淡的；疏远的
unevenly|adv.不平坦地；不均衡地
sieve|n.筛子；粗篮；说话轻率不能保密的人; v.筛；滤
addition|n.增加；加法；附加物
aquifers|含水层
grader|n.分类机；(中小学的)...年级学生
bismarck|n.俾斯麦(普鲁士政治家); n.俾斯麦(美国北达科他州府)
tadpole|n.蝌蚪
invasive|adj.侵入的；侵略性的；攻击性的
bun|n.小面包；圆发髻; n.酒醉
platform|n.月台；讲台；平台；站台；(政党的)政纲
cereal|n.麦片粥；谷类食物; adj.谷类的；谷物的
myths|神话
pyramid|n.金字塔；棱锥体；[证券]金字塔式交易法; v.急速增加；以金字塔的模型构建
fern|n.羊齿植物；蕨
convert|v.(使)转变；使…改变信仰；转化；兑换；换算; n.皈依者；改变信仰的人
thunderstorm|n.雷暴雨；大雷雨
a-|pref.不，无，非；缺少；离；处于...状态或过程中；在…之上；朝着
seawater|n.海水
blade|n.刀刃；刀锋；桨叶；叶片
pistils|雄蕊
jai|n.（印度英语）胜利
mitt|n.手套；手
wagonload|n.一货车的货物；货车装载量
adaptations|适应
formation|n.形成；队形；编队；构造；[地]地层
fre|量子
dye|n.染料；染色; v.染；染色
close-up|n.特写镜头；细致的观察
canal|n.运河；沟渠；气管；食管; vt.建运河；疏导
magnets|磁体
nay|adv.否；不; n.拒绝；反对；投反对票; conj.不但如此；而且
pelican|n.鹈鹕
equation|n.相等；均衡；方程式；等式
burner|n.燃烧器；火炉
diesel|n.柴油机；内燃机; Diesel.; n.迪赛（意大利品牌）
momenta|n.动量(动向；力量)
nephew|n.外甥；侄子
alcohol|n.酒精；酒；乙醇
log|n.原木；圆木；(航海、飞行)日志；(船)计程仪; v.伐木；记入(日志)
hoot|n.鸣笛声；猫头鹰叫声；一点点；好笑的人或事; v.大声叫嚣；(汽笛、喇叭等)呜呜作响；哄赶
incomplete|adj.不完全的；不完整的
pupa|n.蛹
thumb|n.拇指; v.翻阅；示意要求搭车
raindrop|n.雨点；雨滴
automobile|n.汽车; adj.汽车的
doghouse|n.狗舍
asp|n.（尤指北非产的）小毒蛇; n.白杨
density|n.密度；浓度；比重
categorize|v.分类
finch|n.雀类
scissors|n.剪刀
definite|adj.明确的；一定的；有把握的
respell|vt.再拼(读或写)
speck|n.斑点；灰尘；污点；少量; v.用斑点标记
maglev|n.磁力悬浮火车; adj.磁力悬浮火车的
hillside|n.山腰；山坡
urchin|n.顽童；[动]海胆；刺猬
biolog|n.德国一家以创新和科学性为导向的企业；专门提供用于信号转导研究的工具
lumber|n.木材；木料; v.伐木; vi.缓慢地移动; vt.拖累
nonflowering|adj.(尤指苔藓、蕨等)不开花的
exhaust|v.使筋疲力尽；耗尽；详尽论述; n.排气装置；废气
overloaded|adj.超载的；超负荷的
fora|n.论坛(讨论会；专题讲话节目)
barometers|气压计
pumpkin|n.南瓜
non-explosive|不爆炸的,无爆炸性
gravitational|adj.重力的；引力作用的
aquarium|n.水族馆；养鱼缸; 词根：aqu-（表示水）
roller|n.滚筒；滚轴；滚转机；巨浪
poorly|adv.贫穷地；不充份地；贫乏地; adj.身体不舒服的；心情恶劣的
fastener|n.扣件；纽扣；结扎者; =fastening.
puff|vt.喷出；喘息；夸张；膨胀；吹捧; vi.喷出；膨胀；喘息；骄傲; n.一阵；一股；粉扑；泡芙; adj.吹嘘的
aking|n.蛇行
rothschild|n.罗特希尔德家族（闻名的犹太财阀）
lavender|n.熏衣草；淡紫色; vt.用薰衣草薰香
confused|adj.困惑的；混乱的；混杂的
gopher|n.囊地鼠（产自北美的一种地鼠); v.挖洞，打地洞
positively|adv.极其；绝对地；十分肯定的；坚定的
sau|n.分(越南货币名)
taproot|n.直根；主根；根本
bulky|adj.庞大的；笨重的；肥大的
short-lived|adj.短命的；短暂的；短期的；无常的
rectangular|adj.矩形的；长方形的；直角的
fluorescent|n.日光灯; adj.萤光的
graze|v.放牧；（牛、羊等）吃草; v.轻擦；擦伤; n.放牧; n.擦伤
tap|n.龙头；塞子；窃听; n.轻拍；轻敲；鞋掌; v.轻拍；轻击；补鞋掌；选择; v.开发；利用；索要；装龙头；窃听
reh|n.流值
radiate|v.放射；散发；辐射；流露
rap|n.轻敲；拍击；责骂；厉声说出；说唱音乐；谈话；最少量; vi.轻敲；表演说唱音乐；畅谈
runoff|n.径流量；流出；流放口；决赛
renew|v.重新开始；更新
larva|n.幼虫；幼体
sandpaper|n.砂纸; v.打磨
modified|adj.修改的
sponges|海绵动物
gimbals|n.平衡环
lifecycle|n.生命周期；生命循环；生活过程
soom|n.游泳；vi
conto|n.巴西及葡萄牙的钱款数目
perspective|n.远景；看法；透视; adj.透视的
whitecaps|n.浪头白沫
spandrel|n.【建】三角拱腹; =spandril
plantlike|adj.似植物的
repulsion|n.厌恶；反感；[物]排斥；斥力
uy|[域]Uruguay,乌拉圭
ingredient|n.成分；原料；配料；因素
detergent|n.清洁剂; adj.用于清洗的
gentian|n.龙胆属的植物；龙胆根
firebreak|n.防火道；防火线
gulf|n.海湾；鸿沟; vt.吞没
discharge|v.排出；释放；解雇；放电；解除；清偿债务; n.卸货；释放；发射；放电；准许离开；排出物
sage|n.圣人；哲人; n.鼠尾草；蒿属植物; adj.贤明的；明智的
destination|n.目的地；终点
prs|n.偶(对)
wearer|n.穿用者
biofuel|n.生物燃料
mimic|vt.模仿；模拟; n.模仿者；仿制品; adj.模仿的；假的
cloudiness|n.阴暗；光泽暗晦；朦胧
unmix|v.(使)不混合; (使)无法混合.
one-tenth|n.十分之一
lbm|n.磅质量
illustrate|vt.说明；（为书）作插图；图解; vi.举例说明；发亮
rig|n.装备；帆具；服装；钻井架；钻塔; v.装配；装扮；临时赶造；操纵
reenter|v.重新进入
colorful|adj.华美的；富有色彩的；有趣的
uns|adj.不对称的
unscramble|v.整理；解读
clip|vt.夹住; v.剪短; v.疾驰；猛击; n.夹子；弹夹；回形针；钳; n.修剪；(羊毛的)剪下量；(被剪下的)东西
anemone|n.银莲花属植物；海葵
humus|n.腐殖质
seedling|n.幼苗
bu|[经]英斗
humpback|n.驼背；座头鲸；小鲑鱼
incredibly|adv.极其；难以置信地
minimal|adj.最小的；最低限度的
adaptation|n.改编；改编成的作品；适应；【心】（感官）适应，适应性变化
toxic|adj.有毒的
pur|v.咕噜咕噜叫；Pursue追逐；追赶
walnut|n.核桃；核桃木；核桃色；茶色
redesign|vt.重新设计
landslides|滑坡
closely|adv.紧密地；接近地；严密地；亲近地
stink|n.臭味；臭气; vi.发臭味；招人讨厌
buhl|n.布尔细工
hydrologist|n.水文学者
puddle|n.水坑；地上积水；胶泥; v.搅浊；在泥污中打滚；排尿
shrub|n.灌木; n.果汁甜酒
toolbox|n.工具箱
diver|n.跳水者；潜水员
yogurt|n.酸奶；酵母乳; =yoghurt.
flashlight|n.手电筒；闪光灯
valve|n.瓣膜；真空管；阀门；电子管
dough|n.生面团；钱
coastal|adj.沿海的；海岸的；沿岸的
ess|n.字母S；S形之物; -ess:suf.；女的；母的；雌性的
kudzu|n.〈植物〉(产于中国和日本的)葛
accelerator|n.加速装置；油门；[物]加速器；[化]加速剂；促进剂
owl|n.猫头鹰
pave|vt.铺路；铺设；铺满；安排
flatten|vt.使变平；打倒; vi.变平
setup|n.装备；安装；计划
caterpillars|毛虫树
flipchart|翻转图
permanent|adj.永久的；持久的; n.烫发
hammock|n.吊床
toenail|n.脚趾甲；斜钉; v.用斜钉钉牢
dragonfly|n.蜻蜓
pivot|n.枢；中心；旋转; adj.在枢轴上转动的；关键的; vt.装枢轴于；以...为中心; vi.在枢轴上转动
simulate|vt.假装；模拟；模仿
movements|n.动作
antelope|n.羚羊；羚羊皮革
subtract|vt.减去; vi.减少
birdhouse|n.小鸟用鸟笼；小鸟舍；禽舍
frogfish|n.襞鱼科
breakable|adj.易破碎的; n.易碎物品
spinach|n.菠菜
shovel|n.铲；挖斗机；一铲的量; vt.铲；铲成；舀; vi.用铲子
mathematics|n.数学
fulfill|vt.完成；履行；执行；满足
diodes|二极管
interactions|相互作用
palau|n.帕劳（太平洋西部加罗林群岛中的一组火山岛和小岛）; =Belau.
spilling|泄漏
dryer|n.吹风机；干衣机；干燥剂; =drier.
weel|adj.好的; =well; adv.好
enabled|adj.可激活的；已启用的
ree|vt.筛(豆等)
hi|int.嗨(引人注意时的喊声；打招呼)
gin|n.杜松子酒; n.弹棉机；轧花机；陷阱；网; v.用轧棉机去籽；用陷阱（网）捕捉
ammonite|n.[古生]菊石；鹦鹉螺的化石；干肉粉（作肥料用）
moldy|adj.发霉的
droughts|旱灾
hart|n.(五岁以上的)雄赤鹿
omnivore|n.不偏食的人；杂食动物
moisture|n.水分；潮气；湿度
freezer|n.冰箱；冷冻室
reddish|adj.略带红色的；微红的
arow|成列地
loam|n.壤土；沃土; v.用壤土填
backbone|n.脊骨；骨干；骨气；毅力
flexibility|n.灵活性；弹性；适应性；柔韧性
instinct|n.直觉；本能；天性; adj.充满的
disrupt|vt.干扰；打断；妨碍；使分裂；使破裂
specks|n.眼镜
reentry|n.重新进入；（桥牌）再进；[太空]返回
mountainside|n.山坡；山腰
wobble|n.摆动；动摇；不稳定; vi.摇晃；游移不定; vt.使摇晃；使动摇
riddle|n.谜；谜语; vt.解谜；出谜题；充满；打洞；筛选; vi.出谜题
darkness|n.黑暗
vair|n.松鼠皮；毛皮纹
cause-and-effect|因果关系
retired|adj.退休的；退役的
emitters|灌水器
magnolia|n.木兰；木兰属植物
crinkly|adj.起绉的；绉褶多的；卷缩的；沙沙作响的
forewarn|v.预先警告；事先告知
overloading|过载；超载；过负载
funnel|n.漏斗；漏斗状物；烟囱; vt.使成漏斗状；使经过漏斗; vi.形成漏斗状；经过漏斗
pipe|n.管子；烟斗；管乐器; vt.以管输送；装管道；吹奏；尖声说；(为衣服等)滚边; vi.吹奏管乐；尖叫
texture|n.质地；手感；口感；组织；结构；纹理；特点; vt.给予结构
stickiness|n.粘性；粘住
pearlwort|n.[植]漆姑草
chill|v.(使)变冷；(使)扫兴；[冶]冷淬; n.寒冷；扫兴；寒心；着凉; adj.冷淡的；寒冷的
crank|n.曲柄；有怪癖的人；脾气坏的人；妙语；古怪行为; v.用曲柄启动或转动；快速制作; adj.奇异的；古怪的；摇晃的；松动的
pat|n.轻拍；轻打；小块; v.轻拍；抚摸；拍打
roll|n.卷；滚动；名单；压路机；颤音；圆形物，面包卷; v.摇摆；滚；绕；转动；展开
smooth|adj.光滑的；平稳的；流畅的；圆滑的；可口的；安祥的；均匀的; v.使光滑；消除；安慰；理顺(羽毛)
immature|adj.不成熟的
tuck|v.打摺；卷起；收拢；藏起；大吃; n.缝摺；船底后端；食品
mileage|n.英里数；汽车里数津贴；好处
badger|n.獾；獾皮(毛); Badger:獾州人(对威斯康星州人的昵称).; v.纠缠；一再烦扰；吵着要
inner|adj.内心的；内部的；里面的; n.里面
spiral|n.螺旋；螺旋形之物；不断恶化、增加或减少; v.螺旋移动；盘旋上升；不断恶化、增加或减少; adj.螺旋形的；盘旋的
accelerators|加速度表
pistil|n.[植]雌蕊
whisper|n.低语；窃窃私语；飒飒的声音; vi.低声说；窃窃私语；飒飒地响; vt.耳语；私语
recreational|adj.娱乐的；消遣的
kinetic|adj.运动的；动力学的
tin|n.锡；罐头；听头; adj.锡制的; vt.镀锡于
brownish|adj.带褐色的；呈褐色的
liters|公升
uit|(=out)[南非]外的
qr|n.四分之一(一刀纸)
bout|n.回合；一场；一阵；发作；（摔跤等）比赛
high-speed|adj.高速的
axle|n.轮轴；车轴
gas-filled|充有气体的
toothbrush|n.牙刷
armor|n.盔甲；装甲
wash-and-wear|adj.[纺]免烫的；洗后不烫即平的
dispersal|n.散布；传播；分散；疏散区
carton|n.纸板箱；硬纸盒; vt.把...装入纸板箱; vi.制作纸盒
evacuation|n.撤离；疏散; n.排泄；排泄物
screw|n.螺钉；螺丝；螺状物；螺旋桨；螺旋；吝啬鬼；监狱看守人；性交；工资；薪水; v.拧紧；拧；压榨；性交
acorns|坚果
timer|n.计时器；定时器；计时员
observer|n.观察者
sin|n.原罪; v.犯罪；违反(教规)
disguise|vt.掩饰；假装；假扮; n.伪装；伪装物
toothpick|n.牙签
seta|n.刚毛
unchanged|adj.无变化的
rii|(=radio-immuno-image)放射免疫显像,(=radioimmunoimaging)放射性免疫显像
trade-off|n.(对不能同时兼顾的因素)权衡；物物交换，交易；取舍
producer|n.生产者；制造者；制片人
doe|n.母鹿；雌兔；无男子陪伴的女子
wow|n.巨大的成功; int.哇！; vt.使热烈赞赏
wheelchair|n.轮椅
tangle|n.缠结；混乱；纠纷; vt.使缠结；使混乱；使陷入; vi.纠缠；乱作一团；吵架；争论
pea|n.豌豆
yarn|n.纱；线；故事; v.讲故事
niche|n.壁龛；适当的位置；（特定产品或服务的）用户群；[生]生态龛；生态位；小生态环境; vt.放在适当的位置
nights|adv.每晚；在夜晚
assemble|v.集合；收集；装配
representation|n.陈述；表现；表示法
precisely|adv.精确地
brittle|adj.易碎的；尖利的；脆弱的; n.果仁薄脆糖
photosynthesis|n.光合作用
glaciers|冰川
candlewick|n.烛芯
grainy|adj.粒状的；多粒的；木纹状的
moder|n.脉冲信号
drill|n.钻孔机；钻子；反复操练；播种机; v.练习；钻孔；(军事)训练
jg|少尉
classify|vt.分类；归类
diameter|n.直径
ooh|int.噢；呵(表示惊讶、欣喜、痛苦等); vi.以高兴（惊喜等）语调说
copter|n.直升飞机
paroxysmal|adj.发作性的；突发性的
column|n.栏；专栏；列；圆柱；柱；柱形物
dome|n.圆屋顶；苍穹；脑袋；圆形的火山口; vt.加圆屋顶于...上；使成圆屋顶; vi.成圆顶状
compact|adj.紧密的；紧凑的；简洁的; vt.使简洁；使装满；压实; n.合约条约；梳妆粉盒；小型汽车
terrarium|n.动植物饲养园；玻璃容器
interpret|v.口译；解释；翻译；诠释
calculations|计算
grandparents|n.外祖父母；祖父母
mealtime|n.进餐时间；开饭时间
squash|n.壁球；摺皱不堪；拥挤嘈杂的人群；浓缩果汁；美国南瓜; vt.压制；压扁; vi.变扁；挤进
unstable|adj.不稳定的；易变的
snowstorm|n.暴风雪；雪暴
flowchart|n.流程图
warbler|n.莺；啭鸟；鸣鸟；用颤音歌唱的人
saltwater|adj.盐水的；海产的
emperor|n.皇帝
plankton|n.浮游生物
ej|电喷射穿孔
buzzer|n.蜂音器；翁翁作声的东西；信号手；门铃；汽笛
bald|adj.秃头的；单调的；无装饰的; v.（使）变秃头
ser|n.锡厄(印度重量及液体单位)
swan|n.天鹅; vi.闲荡；游荡
piggy|n.小猪; adj.贪心的
transporter|n.运输者；运输装置
unsafe|adj.不安全的；危险的；靠不住的
lantern|n.灯笼；[建]天窗；屋顶气窗
transition|n.转变；过渡
evaporate|v.蒸发；失去水分；消失
livestock|n.家畜；牲畜
humidity|n.湿度；湿气
windmill|n.风车; v.(使）像风车一样旋转
keyboard|n.键盘; v.用键盘输入
dee|n.D字；D字形物
foal|n.驹子; v.生仔
rod|n.杆；棍棒；竿
nitrogen|n.氮
modify|v.修改；更改；缓和；修饰
blueprint|n.蓝图；设计图；(周详的)计划; v.制成蓝图；计划
sod|n.(一块)草皮；草地；家伙；困难的事；鸡奸者; v.用草皮覆盖；诅咒
condense|v.浓缩；凝结；缩短
disfavor|n.厌恶；不悦；失宠；不赞成；不利; vt.不喜欢；不赞成
erf|n.小块土地
calcium|n.钙
esse|n.[哲]存在；实在
biodegradable|adj.生物所能分解的
kitten|n.小猫; vi.生育小猫
tire|n.轮胎；金属圈; v.使疲倦；厌烦；劳累
arrangement|n.布置；安排；约定；商议；改编曲
match-up|n.匹配
iguana|n.〈动〉鼠鳞蜥（一种美洲大蜥蜴）
efficient|adj.效率高的；胜任的
ignite|vi.着火；燃烧; vt.点燃；使...燃烧；引发
multiplying|[计]乘法的
koh|n.鸟叫声
tor|n.岩山；突岩
conductors|列车乘务人员
lore|n.学问；知识；传说；(鸟等的)眼端
insulate|vt.使绝缘；隔离
locomotives|铁道机车
blend|v.混合; n.混合物
camping|n.野营；露营
ditch|n.沟渠；壕沟; vt.丢弃；坠入沟中；飞机（在海上）迫降; vi.挖渠；飞机紧急降落
ney|n.内伊；米哈伊(法国陆军元帅；1769-1815)
planetary|adj.行星的；有轨道的
drip|n.滴；点滴；乏味的人; v.滴下；漏出
technological|adj.科技的；工艺的
shed|vt.除掉；使脱落；使流出；使清晰; n.小屋；车棚
hoover|v.用真空吸尘器把...清除掉；获得大量的(某物); Hoover; n.胡佛吸尘器(商标名)
circular|adj.圆形的；循环的; n.传单；通报
ending|n.结尾；结局
dent|n.凹痕；心理阴影；挫伤; vt.弄凹; vi.形成凹陷
snowball|n.雪球；打雪仗；滚雪球式的募捐法; v.向...丢雪球；使生长或快速的增长
fasten|vt.拴紧；使固定；系；强加于; vi.固定；系紧；抓紧
cardboard|n.厚纸板; adj.厚纸板的；不真实的；无实质的
topsoil|n.表层土; v.去掉表土
apparatus|n.器官；装置；机构；组织；仪器
brainstorm|n.好主意；脑猝病; v.集思广益
poncho|n.斗篷；雨衣
pollinate|v.给...授粉
rub|v.擦；摩擦；搓；惹恼; n.困难；障碍；擦
parallel|adj.平行的；相同的；类似的；并联的; n.对比；平行线(面)；双杠；相似物; vt.相比；相应；与...平行
nonnative|n.非本地的；非本地人
trade-offs|取舍
distraction|n.分心；分心的事物；注意力分散；娱乐；消遣；发狂
explosive|adj.爆炸(性)的；引发争论的；大声的; n.炸药
cataclysmic|adj.灾难性的；剧变的
carpool|vi.合伙使用汽车；拼车
targe|n.圆盾
bai|n.【印度英语】女士；女仆；（Bai）白族（中国少数民族）；（Bai）白语（我国少数民族白族说的语言）
hie|v.快走；赶紧；催促
wavy|adj.波浪形的；起伏的
entomologist|n.昆虫学家
chrysalis|n.蛹；茧
energy-efficient|adj.节约能源的
fractions|形态
real-time|adj.实时的; n.实时
nighttime|n.夜间; adj.夜间的
cirrus|n.[气]卷云；[植]卷须；[动]触毛
archerfish|喷水鱼,射水鱼
ladybug|n.瓢虫
eta|n.希腊语字母的第七字; 估计到达时间(EstimatedTimeofArrival).
atom|n.原子；微粒
gloomy|adj.阴暗的；忧闷的；前景黯淡的
raft|n.筏；木排；救生艇; n.大量; v.乘筏；制成筏
hybrid|n.混合物；杂种；混血儿; adj.杂种的；混合的
flaw|n.瑕疵；缺陷；破绽；裂缝; v.使破裂；有瑕疵
drawback|n.缺点；退税；退款；不利条件；弊
parachute|n.降落伞；缓降物；[动]翅膜; v.跳伞；用降落伞空投
dipper|n.长柄勺；河乌鸟
geothermal|adj.地热的
elevation|n.提升；海拔；高度；提高；立视图
safari|n.旅行；旅行队；狩猎旅行; n.Safari苹果系列产品的默认浏览器名称
pine|n.松树；松木; vi.消瘦；渴望
filament|n.细丝；细线；灯丝；[植]花丝
packing|n.包装
device|n.装置；设备；策略；设计
piezoelectricity|n.压电
airtight|adj.密封的；不透气的；无懈可击的
designers|设计师
volumes|体积
meltwater|n.融水
tui|n.蜜雀(新西兰产)
fireplace|n.壁炉
hare|n.野兔; v.奔跑；飞奔
pantry|n.食品储藏室；餐具室
thrift|n.节俭；节约
comet|n.彗星
lifter|n.升降装置；举东西的人
tan|n.棕褐色；黝黑; v.晒黑；鞣(革)；痛打; adj.棕褐色的
masse|n.[台球]立杆击球; 由动词masser（法语；v.；立杆击球）变化而来
strengths|强项
ey|(=eggyolk)蛋黄,(=emergency)紧急,急症,意外,(=epidemiologyyear)流行病学年
closet|n.壁橱；衣帽间；密室；厕所; adj.隐藏的；不公开的；空谈的; vt.把...关在房间里
transferred|v.转移；移动；迁移; vbl.转移；迁移；转让
axo|轴胞体突触
heater|n.加热器；火炉；加热之人
eruption|n.爆发；喷发；出疹；长牙
rho|n.ρ(希腊字母的第17字)
loo|n.厕所；纸牌游戏
salmon|n.鲑；大马哈鱼；橙红色的
availability|n.有效；有用；有益；可得到的人(或物)；可用性
ostrich|n.驼鸟；驼鸟般的人
developing|adj.发展中的
rebreather|再生式氧气系统,呼吸器,换气器
prototype|n.原型；范例；雏形
shorts|n.短裤
concepts|概念
linea|n.混线；线间短路
ballpark|n.棒球场；变动范围
fertile|adj.肥沃的；富饶的；能繁殖的；多产的；（创造力）丰富的
frees|v.解放
cumulus|n.积云；堆积
variable|adj.可变的；易变的; n.变量；易变的东西
locomotive|n.火车头；机车; adj.运动的；火车头的；旅行的
xii|n.十二; adj.十二的
disperse|v.分散；散开
videogames|电子游戏
sari|n.(印度妇女的)莎丽服
coaster|n.杯垫；小托盘；惯性运转装置；沿海航行船
dey|n.(法国殖民者在阿尔及尔的)总督
fossil|n.化石；食古不化的人；守旧的事物
grace|n.优美；优雅；恩惠; vt.使优美；使荣耀
drought|n.干旱
shred|v.撕成碎片; n.碎布条；细片；少许
plaint|n.起诉；诉状；悲叹；诉苦
correctly|adv.正确地；恰当地
rounder|n.巡回者；搓圆机；浪子；放荡的人; rounders:跑注式棒球.
environments|环境
hanger|n.挂钩；衣架；悬挂物
hardness|n.坚硬；困难；严厉
astronomical|adj.天文学的；巨大的
improperly|adv.不正确地；不适当地
diaper|n.尿布；菱形花纹的织物; vt.换尿布；装饰菱形花纹
piper|n.吹笛者；风笛手
storage|n.保管；贮藏；仓库；保管费；[计]存储器
generate|vt.产生；发生；引起
electron|n.电子
coyote|n.小狼；丛林狼
alert|adj.警觉的；灵敏的; vt.使意识到；警惕; n.警戒；警报
compound|n.化合物；复合词；复合物; n.院子(用围墙圈起来的场地）; adj.化合的；【语】（词语等）复合的；【植】复合的；【动】群体的; vt.混合；调合；使严重；私了；【经】以复利计算; vi.妥协
cun|寸
turbines|涡轮
vulture|n.秃鹰；兀鹰；贪婪的人
reservoir|n.水库；储藏；蓄水池；积蓄
fertilizer|n.肥料
leftover|n.剩饭；残留物; adj.残余的
attractions|知名旅游吸引物
stir|vt.激起；惹起；搅和; vi.活动；引起；挪动; n.骚乱；感动(激动；愤怒或震动)；搅拌
pulley|n.滑车；滑轮；皮带轮
neutron|n.中子
specimen|n.标本；样本
instantly|adv.立即地；即刻地
downstream|adv.朝下游方向; adj.顺流的
north-seeking|寻北
eip|(=end-inspiratorypause)吸气末暂停,(=eosinophilicinterstitialpneumonia)嗜酸细胞性间质性肺炎,(=extensorindicisproprius)(拉)食指固有伸肌
dda|[计算机]数字微分分析器
jot|n.少量; v.草草记下；匆匆记下
mold|n.模式；类型；模子；模型；真菌；软土; vt.形成；制模；发霉; vi.发霉；符合形状
sailboat|n.(比赛、休闲用的)帆船
drawbacks|弊端
botanist|n.植物学家
waxy|adj.像蜡的；蜡色的；苍白的；光滑的；顺从的
stopwatch|n.记秒表；跑表
inclined|adj.倾向于...的
embryo|n.胚胎；萌芽
bake|v.烤；烘焙；烘干；灼热
multiple|adj.多种多样的；许多的; n.倍数；并联
shore|n.岸；滨
oxpecker|n.[鸟]黄嘴(或红嘴)牛椋鸟
bis|adv.重复；两次; int.再来一个；再演一次
lubb|[医]路布(摹拟第一心音)
pointer|n.指针；教鞭；（能指出猎物位置的）猎犬；暗示；主意; Pointer:指极星.
fuel-efficient|adj.耗油低的；燃料消耗低的
renewable|adj.可更新的；可再生的
remit|vt.汇出；提交；宽恕；免除；延迟; vi.汇款；缓和；减轻; n.移交事项
spore|n.孢子; v.产生孢子
gyroscope|n.陀螺仪；回转仪
classroom|n.教室；课堂
woodpecker|n.啄木鸟
laptops|笔记本电脑
rattlesnakes|响尾蛇
lto|低温氧化物
horned|adj.有角的；角状的
flit|v.轻快地飞；掠过；搬家(尤指为躲债); n.掠过；搬家
generator|n.发电机；发生器
lever|n.杠杆；控制杆；手段; v.撬开；使用杠杆
vibrate|vt.(使)振动；(使)摇摆; vi.回响；颤动
seaweed|n.海草；海藻
cubic|adj.立方体的；立方的
electronic|adj.电子的；电子学的
unequal|adj.不相等的；不平等的；不胜任的
transpiration|n.植物的蒸腾（作用）；蒸发；〈医〉不自觉性出汗
transformation|n.转型；转化；改造
collisions|碰撞
dishwashers|洗盘机
decomposition|n.分解；腐烂；变质
chilly|adj.寒冷的；冷淡的; n.干辣椒
blackberry|n.黑莓
tank|n.箱；罐；槽；贮水池；坦克; vt.把...储于槽中
dimensional|adj.维度的；次元的；空间的；尺寸的
catastrophic|adj.灾难的；灾难性的
organ|n.器官；风琴；机构；喉舌；报刊
mighty|adj.强大的；巨大的; adv.很；极其
nutter|n.采集坚果的人；疯子
grand|adj.重大的；豪华的；宏伟的；壮丽的; n.大钢琴；一千美元
spoiling|n.钢的碳化物分解变坏
inscience|n.无知
rainstorm|n.暴风雨
constellation|n.星座；星群
nonelectronic|adj.非电子的
conditioning|n.调节；训练；[心]条件作用
socket|n.插座；插口；窝；穴孔；套接口，套接字; vt.装上或插入插座
controllers|控制器
groove|n.槽；纹；习惯; v.开槽；使...快活
hint|n.暗示; v.暗示；示意
refillable|adj.适于再装的；可重复充填的
wop|n.意大利人；意大利人后裔
bj|(=bencejonesproteintest)本周(氏)蛋白试验,轻链蛋白试验,(=bicepsjerk)二头肌反射,(=bielschowsky-jansky)比-詹二氏综合征
sow|v.播种；散布; n.母猪
ater|n.纯黑色
insulators|隔离工
grip|n.紧握；手提包；了解；手柄; vt.吸引；紧抓
decay|v.(使)衰退；(使)腐败；(使)腐烂; n.衰退；腐烂；腐败
locate|vt.找出；把...设置在；使坐落于; vi.住下来
description|n.描述；刻画；类型；说明书
increments|增量
lle|(=leftlowerextremity)左下肢,(=liquid-liquidextraction)液-液提取法,液液萃取
electrostatic|adj.静电的；静电学的
dust-free|adj.无尘的；无灰的
cattail|n.[植]香蒲；香蒲属植物
cannon|n.大炮；机关炮; v.开炮；相撞
fuzz|n.细毛；绒毛；警员; v.起毛；（使）变得模糊不清
electrician|n.电工；电气技师
frame|n.骨架；身躯；结构；框；帧; v.表达；制定；把...框起来；陷害
dropper|n.滴管；使滴下的东西
toad|n.蟾蜍；癞蛤蟆
travelers|旅游者
foy|n.饯行宴会；临别礼物
gripe|n.抱怨；肠绞痛; v.抱怨；使...痛苦；抓住；掌握
coating|涂层；衣料
steeper|n.浸润用的桶子
improvement|n.改进；改善
slushy|adj.融雪的；泥泞的；无聊的
chaser|n.猎人；驱逐舰；烈酒后饮品；雕刻工；螺纹梳刀
plug|n.塞子；插头；推销；火花塞；口嚼烟; v.塞；堵；宣传；插上插头；苦干
hazard|n.危险；冒险；危害; vt.冒险；赌运气; 阿扎尔（英超切尔西队球员）
biomedical|adj.生物医学的
perch|n.栖木；高位；杆；河鲈鱼; v.栖息；就位；位于
gap|n.缺口；裂缝；差距；空白
lifeguard|n.救生员
