unload|vt.卸下；卸货；摆脱...之负担；(大量)倾销；退出（弹药；胶片等）; vi.卸下货物；摆脱负担
faulty|adj.有缺陷的；不合格的；有错误的；有缺点的
crawfish|n.小龙虾
document|n.文件；公文；文档; vt.记载；(用文件等)证明
realistic|adj.现实的；现实主义的
hairless|adj.无毛的
kennel|n.狗舍；养狗场；排水道; v.置于狗舍；宿于狗舍
unnatural|adj.不自然的；反常的；不近人情的
polar|adj.两极的；对立的; n.极线；极性
temporarily|adv.暂时地；临时地
flagpole|n.旗竿; =flagstaff.
establish|v.建立；确立；创办；安顿
twelfth|adj.第十二的；十二分之一的; n.第十二；十二日；第十二音
bulldozer|n.推土机；欺凌者
agent|n.代理人；代理商；药剂；特工人员
amusing|adj.有趣的；引人发笑的
ashamed|adj.感到惭愧的；感到害臊的
sunup|n.日出
lift|vt.举起；运送；偷窃；升高；还清；取消; vi.提升; n.举起；提升；电梯；搭便车；帮助；载货量；扒窃
term|n.学期；术语；条件；条款；期限；名词; vt.把...称为
overboard|adv.自船上落下；在船外
skyscrapers|摩天楼
shade|n.阴影；遮蔽；遮光物；(色彩的)浓淡; vt.遮蔽；使阴暗；使渐变；略减（价格）; vi.渐变
claw|n.爪；钳；螯；爪状物; v.抓；撕
wasp|n.黄蜂；胡蜂
punctuation|n.标点；强调
sort|n.种类；某一种人; v.整理；分类；处理；安排妥当
foreigner|n.外国人；外人
accompany|vt.陪伴；伴随...发生；补充；给...伴奏; vi.伴奏
talented|adj.有才能的；有天赋的
yolk|n.蛋黄
pour|v.不断流动；倒；倾泻；蜂涌而来; n.倾泻
class|n.等级；阶级；阶层；班级；课；[生]纲；出色的风度; v.分类
visitor|n.参观者；访问者；访客
embassy|n.大使馆；大使全体人员
rope|n.绳索；一串；绞刑; v.捆绑；说服（口）
disguise|vt.掩饰；假装；假扮; n.伪装；伪装物
colds|n.感冒
temptation|n.诱惑；引诱物
sympathetically|adv.同情地；表示好感地
stepsister|n.异母(或异父)的姐妹
clicker|n.发咔哒声者（如电脑鼠标或遥控器等）；鞋匠工头；排字工头；站店外招徕顾客者
buttoned|adj.用钮扣装饰的；扣紧的
porcupine|n.豪猪；箭猪
general|adj.普遍的；全面的；一般性的；大致的；笼统的；常规的；总的；首席的; n.将军；一般
wonder|n.惊奇；惊愕；奇迹；奇观; v.惊奇；想知道；怀疑; adj.奇妙的；非凡的
foss|n.沟；渠道；护城河; =fosse.
lanterns|灯具
inlet|n.水湾；入口；插入物; vt.引进；插入
lunchtime|n.午餐时间
church|n.礼拜仪式；教堂；基督教徒; adj.教堂的; v.把...带到教堂接受某种宗教仪式
aid|n.援助；帮助；救援；助手；辅助物; v.辅助；援助；接济
butcher|n.屠夫；刽子手；肉商；小贩; vt.屠宰；滥杀；将某事弄得一团糟
matter|n.事情；事态；问题；关于...的事情；物质；重要性; v.有关系；要紧
devotion|n.虔诚；献身；奉献；热爱
retire|v.退休；撤退；离去；就寝；主动退出比赛；收回（货币）；赎回（票据）; n.退休，退职
excursion|n.远足；短途旅行；【物】偏移，漂移，偏离；偏差，偏振
collapse|v.（使）倒塌；（使）崩溃；（使）瓦解；折叠; n.倒塌；崩溃；暴跌
possess|vt.拥有；持有；支配
cucumbers|黄瓜
thoroughly|adv.彻底地；完全；非常
packing|n.包装
courtyard|n.庭院；院子
tankers|油船
prize|n.奖品；奖金；奖赏; vt.珍视；估价; adj.奖品的；得奖的；一流的
stick|n.手杖；枝；杆; vt.刺入；插于；竖起; vi.钉住；坚持，遵守；粘贴；生效，起作用
gate|n.大门；登机门；出入口；门票收入；道路；方式; v.惩罚(禁止学生离校)；解雇; suf.常表示政治丑闻
nee|adj.娘家姓...的
pause|n.暂停；中止；犹豫不决; vi.停顿；中止
chase|vt.追捕；追求；镂刻，雕刻；试图赢得; vi.奔跑；追赶; n.追捕；争取；狩猎
fever|n.狂热；发烧；发热; v.（使）发烧；（使）狂热
brand|n.烙印；商标；牌子；标记; vt.加污名于；铭记；打烙印
awkwardly|adv.别扭地；拘谨地；尴尬地；笨拙地
quit|v.停止；离开；退出；辞职
enormous|adj.巨大的；庞大的
grasp|n.把握；领会；抓紧; vt.领会；抓住；紧握
master|n.主人；硕士；专家; vt.控制；精通; adj.主要的；主人的；精通的
dip|v.浸；蘸；下沉；倾斜；掏取；浏览; n.浸泡；浸；蘸；倾斜；下降
bargain|n.交易；便宜货；契约; v.讨价还价；议价；(谈价钱后)卖
employer|n.雇主
hostess|n.女主人；空姐；女主持
clunk|n.沉闷的金属声；愚蠢乏味的人; v.发出沉闷声；打击某物（使）发出沉闷声地
drily|adv.幽默而不形于色地；冷淡地；干燥地
critic|n.评论家；批评家
tracer|n.追踪者(器)；示踪物；曳光弹；[化]示踪剂
department|n.部门；系；科；处；局; n.知识范围
worthwhile|adj.值得(做)的
frightful|adj.可怕的；吓人的
chime|n.鸣；钟；和协; v.鸣；打；和协
ventilation|n.通风；通风设备；充气；公开讨论
lop|v.剪去(树枝)；砍掉；削减；耷拉下来
twin|adj.孪生的；紧密联系的; n.双胞胎之一
sac|n.囊；液囊
liberty|n.自由；自由权；冒失
permission|n.许可；允许；同意
blurt|vt.冲口说出；突然说出
vacant|adj.空虚的；空的；木然的
broadcast|v.广播；散布；撒播; n.广播；广播节目
attractive|adj.有吸引力的；有魅力的
remark|n.评论；备注；注意; v.评论；注意到
