technology|n.技术；工艺；工艺学
reproduce|v.再生；复制；生殖
movement|n.活动；运动；动作；[音]乐章
bell|n.钟；铃；门铃；钟声；钟状物; vt.敲钟；使象钟状地张开; vi.使呈钟状；张开
crystal|n.水晶；结晶体；表蒙子; adj.透明的；晶体的
career|n.生涯；职业；事业; vi.猛冲；飞跑
pose|v.摆姿势；把...摆正位置；造成；提出；假装; n.姿态；姿势；装腔作势
agency|n.代理；代理处；政府机构
leader|n.领袖；领导者；指挥者；领先的人
push|v.推；按；挤；逼迫；催促; n.推；奋力；决心
looks|n.外貌(恒用复数)
differently|adv.不同地
copyright|n.版权；著作权; v.获得版权; adj.受版权保护的
reserved|adj.保留的；预订的；含蓄的；缄默的
stretch|v.伸展；延伸；张开；夸大; n.伸展；张开；弹性；一段时间；刑期; adj.可伸缩的
technology|n.技术；工艺；工艺学
network|n.网点；网络；网状系统；广播公司
delivery|n.传递；交付；递送；分娩；转让；演讲姿态；投球
robots|机器人
being|n.存在；人；生物；本质
delivery|n.传递；交付；递送；分娩；转让；演讲姿态；投球
technology|n.技术；工艺；工艺学
carefully|adv.小心地，谨慎地；仔细地，认真地
road|n.路；道路；途径；方法
junction|n.连接；会合处；交叉点
buggy|adj.多虫的; n.轻型马车；婴儿车
snowy|adj.多雪的；被雪所覆盖著的；下雪的
sidewalk|n.人行道; =pavement（英）.
button|n.纽扣；按钮; v.扣上纽扣；用纽扣装饰
inventors|发明者
robots|机器人
roam|v.漫游；闲逛；徜徉
streets|街道
cell|n.单人牢房；小房间；细胞；蜂房的巢室；电池；政治小组；(计算机电子表格的)单元格；手机
doorbell|n.门铃
code|n.密码；法规；准则; v.制成法典；把...编码
container|n.容器；集装箱
safely|adv.安全地；稳定地；有把握地；无风险地
microphones|麦克风
push|v.推；按；挤；逼迫；催促; n.推；奋力；决心
tricky|adj.棘手的；狡猾的；巧妙的
cameras|照相机；暗箱；摄像机；摄影机
sensors|传感器
tricky|adj.棘手的；狡猾的；巧妙的
robotic|adj.机器人的；像机器人的
snack|n.小吃；点心; vi.吃点心
motorcycle|n.摩托车; v.骑摩托车
version|n.版本；说法；译本；形式
associated|adj.联合的；相关的
zipping|n.尖啸声(拉链)
exciting|adj.令人兴奋的；使人激动的
pricey|adj.昂贵的；过分昂贵的
turning|n.旋转；回转；转向
runway|n.跑道；河床；悬索道；滑沟
zoom|v.急速上升；嗡嗡作响；（镜头）拉近（拉远）; n.急速上升；嗡嗡声；(摄影)变焦
rear|adj.后面的；后方的；背面的; n.后部；尾部；后方; v.举起；养育；饲养
boost|v.提高；增加；鼓励；举起；为...做宣传; n.增加；推进；鼓励
mostly|adv.主要地；通常
suddenly|adv.突然地
rewritten|v.再写(书面答复)
boulder|n.大圆石；巨砾
motor|n.马达；发动机；机动车; adj.机动的；汽车的；运动神经的
cord|n.细绳；索；纽带
slope|n.倾斜；斜坡；斜面；斜率；斜线; vt.使倾斜; vi.倾斜；有坡度
scratch|v.抓；搔（痒）；划破；划掉; n.抓痕；乱写；抓的声音；起跑线; adj.无让步的
steady|adj.稳定的；稳固的；坚定的; v.使稳固；使稳定；(变得)稳固；使坚定; adv.稳定地，稳固地; n.关系固定的情侣；固定支架
higher|adj.更高的；高等的
ski|v.滑雪; n.滑雪板；雪橇
Beginners|零起点
slope|n.倾斜；斜坡；斜面；斜率；斜线; vt.使倾斜; vi.倾斜；有坡度
pond|n.池塘
balanced|adj.均衡的；平衡的；平稳的
ape|n.猿; adj.疯狂的; v.模仿
gorillas|n.大猩猩；暴徒（gorilla的复数）
Chimpanzees|n.黑猩猩属
silly|adj.愚蠢的；琐屑的；可笑的；犯晕的; n.（通常指小孩子）淘气鬼；傻孩子
gorillas|n.大猩猩；暴徒（gorilla的复数）
unlike|adj.不同的，不相似的; prep.不像，与…不同；与...平时不同
trunk|n.树干；(汽车后部)行李箱；大箱子；象鼻；躯干; (复)trunks:男用运动裤.
cliff|n.悬崖；峭壁
cavern|n.大洞穴; v.置于洞穴中；挖空
cave|n.洞穴；山洞; v.挖空；塌落；屈服
roof|n.屋顶；顶; vt.覆盖；给...覆以屋顶
