chill|v.(使)变冷；(使)扫兴；[冶]冷淬; n.寒冷；扫兴；寒心；着凉; adj.冷淡的；寒冷的
cellar|n.地窖；地下室; vt.把...藏入地窑
clockwise|adj.顺时针方向的; adv.顺时针方向地
demi|pref.半
reunion|n.团聚；联合
cigar|n.雪茄烟
crown|n.王冠；王权；花冠；顶点；齿冠；克朗（丹麦、瑞典、捷克等国的货币单位）; vt.加冕；使...成王；居...之顶；镶齿冠；使圆满；打…的头部
blindfold|v.蒙住...的眼睛; n.蒙眼物；盲目; adj.被蒙上眼睛的
creator|n.创造者；[计]创建者; Creator.; n.上帝
compartment|n.间隔；个别室；卧车包房; vt.划分
boot|n.靴子；猛踢；解雇；[英]汽车行李箱; vt.踢；穿靴子；逐出；启动(计算机)
unbelievable|adj.难以置信的
developing|adj.发展中的
cracking|n.分裂；分解; adj.很快的；很好的；很美的; adv.很快地；很好地；很美地
lid|n.盖子；眼睑; vt.给...装盖子
deck|n.甲板；层面；一副牌; vt.装饰；用力击倒
deli|n.(=delicatessen)熟食店
bet|v.打赌；确信无疑; n.赌注；确信
compliant|adj.适用的；顺从的
frown|n.皱眉；不悦; v.不同意；皱眉头
collapsed|adj.倒塌的
robe|n.长袍; v.(使)穿上长袍
darkness|n.黑暗
churn|n.搅乳器; v.搅拌；搅动；翻腾；〈口〉粗制滥造
conserve|n.蜜饯；果酱; v.保存；保持；节省；用糖保存
marvelous|adj.令人惊异的；非凡的; =marvellous
detour|n.绕路；便道; v.绕路而行
conquer|vt.征服；克服；战胜; vi.得胜
click|n.咔嗒声；[计]点击; v.（使）发出咔嗒声；点击
hooded|adj.戴头巾的；有兜帽的；有罩盖的；[动]有冠顶的
convert|v.(使)转变；使…改变信仰；转化；兑换；换算; n.皈依者；改变信仰的人
cope|vi.应付；对抗；妥善处理; vt.笼罩；盖上斗篷; n.长袍；斗篷状物
appetite|n.食欲；嗜好；欲望
disk|n.圆盘；唱片；花盘；磁盘；盘形物
cocoon|n.茧；茧状物; v.包围；包裹
demotic|adj.平民的；民众的；通俗的
crocodile|n.鳄鱼
cha|n.茶
dedication|n.奉献；献词；献堂礼
bolt|n.门闩；螺栓；一卷布；弩箭; v.（突然）逃离；闩住；狼吞虎咽；用螺栓固定; adv.挺直地
cower|v.畏缩；退缩；抖缩
fairy|n.仙女；小精灵; adj.优雅的；幻想中的；虚构的
paddle|n.桨；划桨；明轮翼; v.划桨；戏水；抚弄
unharmed|adj.没有受伤的；无恙的
clan|n.氏族；宗族；党派
dabble|v.喷洒；玩水；泼溅；涉猎；浅尝
shortage|n.不足；缺少，短缺
desperate|adj.绝望的；不顾一切的；极其想要的
stinky|adj.恶臭的
harness|n.马具；安全带；甲胄；系在身上的绳子; vt.束以马具；披上甲胄；利用；管理；控制
ceiling|n.天花板；上限
pillar|n.柱子；支柱；核心(人物); vt.用柱支持
raging|adj.狂暴的；非凡的；熊熊燃烧的
tone|n.语气；音调；调子；色调；风气; v.使更健壮；定调；调色；装腔作势地说
clench|v.紧握；紧咬；牢牢地抓住；确定; n.牢牢抓住；钉紧
steaming|n.汽蒸(蒸烘)
craggy|adj.多峭壁的；棱角分明的
circus|n.马戏团；马戏表演；竞技场；广场
nonstop|adj.直达的；不断的；不间断的; adv.直达地；不间断地; n.直达车；直达行驶
composed|adj.镇静的；沉着的；由…组成的
charm|n.魅力；吸引力；迷人；美貌; v.（使）着迷；施魔法
bloody|adj.流血的；血腥的；嗜杀的; vt.使流血; adv.[俚]非常
mere|adj.仅仅的；纯粹的
uncover|vt.揭开；揭露
creation|n.创造；创作
demon|n.魔鬼；恶魔；精力充沛的人；高手
disgusting|adj.令人厌恶的
chipmunk|n.[动]花栗鼠
syrup|n.糖浆；甜而黏稠的汁液
curdle|v.凝结；变稠; v.(使)结成凝乳；变成凝乳状
hearth|n.炉床；灶台；炉边
grandson|n.孙子；外孙
linger|vi.徘徊；逗留；消磨；漫步
supporter|n.支持者；拥护者；支撑物
charitable|adj.仁慈的；(为)慈善事业的；宽恕的
