ante|n.(纸牌游戏中发牌钱下的)赌注；(需预付的)款项; v.下赌注；付款; pref.表示“前”
shortage|n.不足；缺少，短缺
stitch|n.一针；疼痛；碎布条; v.缝合
thoughtful|adj.深思的；体贴的
boast|v.自夸；吹牛；以...为荣; n.自夸；引以为荣的事物
bordering|n.边缘(设立疆界；边界标志物)
nephew|n.外甥；侄子
unpredictable|adj.不可预知的
needlepoint|n.针尖；针绣花边
uncover|vt.揭开；揭露
nasty|adj.下流的；严重的；令人不快的；难懂的；危害的
neatly|adv.整洁地；熟练地
tug|n.用力拉；拖船; v.用力拉
pup|n.小狗；小海豹；小伙子
olive|n.橄榄；橄榄树；橄榄色; adj.黄褐色的；橄榄色的
unbelievable|adj.难以置信的
non|adv.[拉]非；不是
grudge|n.怨恨；恶意; vt.不愿；吝惜；嫉妒
cuff|n.袖口；手铐; n.巴掌; v.为...上袖口；带手铐; v.轻拍；掴
mist|n.雾；迷蒙；朦胧不清; vt.使…模糊；蒙上雾; vi.使模糊；下雾
fog|n.雾；朦胧；迷惑; v.以雾笼罩；使模糊；迷惑
myth|n.神话；虚构的故事
momentous|adj.重要的；重大的
newsroom|n.编辑部；报章杂志阅览室；报纸贩卖部
sorts|n.种类; 分类.
nap|n.小睡；绒毛；纳普牌; vi.打盹；疏忽
mule|n.骡子；固执的人；走私毒品者; n.拖鞋
eerie|adj.怪诞的；可怕的；奇异的；害怕的
lair|n.(野兽的)巢穴；(人的)藏身处
muddy|adj.泥泞的；浑浊的；糊涂的; v.使沾上烂泥；使...混浊；使迷惑
waking|adj.醒着的
mysteriously|adv.神秘地；故弄玄虚地
fairy|n.仙女；小精灵; adj.优雅的；幻想中的；虚构的
boar|n.野猪；公猪
ah|int.啊；哈; =aah.
magically|adv.如魔法般地；用魔法地
necked|v.颈缩(冲槽); adj.压缩的
victorious|adj.胜利的；得胜的
sniff|vi.嗅；嗤之以鼻；找出; vt.嗅到；吸入；嗤之以鼻地说; n.嗅；吸气；气味
vicious|adj.恶毒的；恶意的；剧烈的；堕落的
invincible|adj.不可征服的；不能战胜的
apiece|adv.每人；每个；各
odor|n.气味；名声；气息
spelling|n.拼法；拼写
hardworking|adj.努力工作的；勤奋的
mug|n.脸；杯；一杯的量；恶棍; v.打劫；突击学习
proudly|adv.傲慢地；自大地；得意洋洋地
mere|adj.仅仅的；纯粹的
trickle|vi.滴流；慢慢移动; n.细流；徐徐地流
moonlight|n.月光; v.兼职; adj.夜间的
respectful|adj.表示尊敬的；有礼貌的；谦恭的
reunion|n.团聚；联合
ness|n.岬；海角
detour|n.绕路；便道; v.绕路而行
tee|n.字母t；形状像字母T的东西; [游戏]目标.; [高尔夫球]发球的球座.; v.将（高尔夫球）置于球座
lid|n.盖子；眼睑; vt.给...装盖子
mornings|n.每天上午；在任何上午
boot|n.靴子；猛踢；解雇；[英]汽车行李箱; vt.踢；穿靴子；逐出；启动(计算机)
technically|adv.技术上；学术上；严密地
stomp|vt.跺（脚）；重踏; n.跺脚舞；顿足爵士舞乐曲
shabby|adj.破旧的；寒酸的；低劣的，无耻的；卑劣的
edition|n.版；版本
routine|n.例行公事；常规；无聊; adj.常规的；例行的；乏味的
misfortune|n.不幸；灾祸
newly|adv.新近地；重新地
frantic|adj.疯狂的；狂乱的；急忙的
thee|pron.[古]你；汝；你自己
fiend|n.魔鬼；邪神
scenery|n.风景；背景；布景
mutter|v.咕哝；抱怨；低语; n.嘟哝；抱怨；低语
muse|v.沉思；冥想; n.沉思；[大写]（希腊神话）缪斯；艺术家的灵感；诗人
mishap|n.不幸之事；灾祸；恶运
downstream|adv.朝下游方向; adj.顺流的
hint|n.暗示; v.暗示；示意
intensive|adj.密集的；彻底的；精细的；强调的; n.(语法)强调成份
